#separator:tab
#html:false
#guid column:1
#deck column:1
eo0_G	Ελληνικά::Ρήματα::Τύπος Α	читаю	διαβάζω, διάβασα, θα διαβάσω
>DGe4	Ελληνικά::Ρήματα::Τύπος Α	готовлю (еду)	μαγειρεύω, μαγείρεψα, θα μαγειρέψω
l(`_9	Ελληνικά::Ρήματα::Τύπος Α	открываю	ανοίγω, άνοιξα, θα ανοίξω
=,JfD	Ελληνικά::Ρήματα::Τύπος Α	закрываю	κλείνω, έκλεισα, θα κλείσω
-W.!R	Ελληνικά::Ρήματα::Τύπος Α	пишу	γράφω, έγραψα, θα γράψω
%Nro4	Ελληνικά::Ρήματα::Τύπος Α	играю	παίζω, έπαιξα, θα παίξω
5wHjU	Ελληνικά::Ρήματα::Τύπος Β1 + Β2	люблю	αγαπάω, αγάπησα, θα αγαπήσω
D6j0J	Ελληνικά::Ρήματα::Τύπος Β1 + Β2	опаздываю (менее форм.)	αργώ, άργησα, θα αργήσω
|<4~J	Ελληνικά::Ρήματα::Τύπος Β1 + Β2	помогаю	βοηθάω, βοήθησα, θα βοηθήσω
z:uaT	Ελληνικά::Ρήματα::Τύπος Β1 + Β2	объясняю	εξηγώ, εξήγησα, θα εξηγήσω
da@hG	Ελληνικά::Ρήματα::Τύπος Β1 + Β2	живу	ζω, έζησα, θα ζήσω
^j[!F	Ελληνικά::Ρήματα::Τύπος Β1 + Β2	разговариваю	μιλάω, μίλησα, θα μιλήσω
=@yG2	Ελληνικά::Ρήματα::Τύπος Β1 + Β2	просыпаюсь	ξυπνάω, ξύπνησα, θα ξυπνήσω
+|ln	Ελληνικά::Ρήματα::Τύπος Β1 + Β2	гуляю, иду пешком	περπατάω, περπάτησα, θα περπατήσω
T6y,B	Ελληνικά::Ρήματα::Τύπος Β1 + Β2	спрашиваю	ρωτάω, ρώτησα, θα ρωτήσω
RG;4G	Ελληνικά::Ρήματα::Τύπος Β1 + Β2	останавливаюсь	σταματάω, σταμάτησα, θα σταματήσω
wCV3E	Ελληνικά::Ρήματα::Τύπος Β1 + Β2	звоню по телефону	τηλεφωνώ, τηλεφώνησα, θα τηλεφωνήσω
z^bJ1	Ελληνικά::Ρήματα::Τύπος Β1 + Β2	пою	τραγουδάω, τραγούδησα, θα τραγουδήσω
qI^H6	Ελληνικά::Ρήματα::Τύπος Β1 + Β2	приветствую	χαιρετάω, χαιρέτησα, θα χαιρετήσω
&9Tt8	Ελληνικά::Ρήματα::Τύπος Β1 + Β2	использую	χρησιμοποιώ, χρησιμοποίησα, θα χρησιμοποιήσω
kSK+L	Ελληνικά::Ρήματα::Τύπος Β1 + Β2	смеюсь	γελάω, γέλασα, θα γελάσω
f0yFP	Ελληνικά::Ρήματα::Τύπος Β1 + Β2	хочу пить	διψάω, δίψασα, θα διψάσω
7-9<N	Ελληνικά::Ρήματα::Τύπος Β1 + Β2	хочу есть	πεινάω, πείνασα, θα πεινάσω
ks-FQ	Ελληνικά::Ρήματα::Τύπος Β1 + Β2	ломаю, порчу	χαλάω, χάλασα, θα χαλάσω
Y:j+K	Ελληνικά::Ρήματα::Τύπος Β1 + Β2	прохожу, провожу (время)	περνάω, πέρασα, θα περάσω
](*EQ	Ελληνικά::Ρήματα::Τύπος Β1 + Β2	забываю	ξεχνάω, ξέχασα, θα ξεχάσω
.DnPT	Ελληνικά::Ρήματα::Τύπος Β1 + Β2	зову	καλώ, κάλεσα, θα καλέσω
!i)DN	Ελληνικά::Ρήματα::Τύπος Β1 + Β2	могу	μπορώ, μπόρεσα, θα μπορέσω
vj9lT	Ελληνικά::Ρήματα::Τύπος Β1 + Β2	испытываю боль	πονάω, πόνεσα, θα πονέσω
J^:7G	Ελληνικά::Ρήματα::Τύπος Β1 + Β2	надеваю	φοράω, φόρεσα, θα φορέσω
^J7/U	Ελληνικά::Ρήματα::Исключения	я есть	είμαι, ήμουν, θα είμαι
+wrwC	Ελληνικά::Ρήματα::Исключения	имею	έχω, είχα, θα έχω
o$azP	Ελληνικά::Ρήματα::Исключения	делаю	κάνω, έκανα, θα κάνω
&R?08	Ελληνικά::Ρήματα::Исключения	знаю	ξέρω, ήξερα, θα ξέρω
?(I2E	Ελληνικά::Ρήματα::Исключения	иду (в общем)	πάω/πηγαίνω, πήγα, θα πάω
Nb!~K	Ελληνικά::Ρήματα::Исключения	жду	περιμένω, περίμενα, θα περιμένω
q,2RC	Ελληνικά::Ρήματα::Исключения	кладу, ставлю / положи	βάζω, έβαλα, θα βάλω / βάλε
xms|J	Ελληνικά::Ρήματα::Исключения	достаю, вытаскиваю	βγάζω, έβγαλα, θα βγάλω
g5`WU	Ελληνικά::Ρήματα::Исключения	даю	δίνω, έδωσα, θα δώσω
eh%YH	Ελληνικά::Ρήματα::Исключения	понимаю	καταλαβαίνω, κατάλαβα, θα καταλάβω
;$[7P	Ελληνικά::Ρήματα::Исключения	изучаю, учу	μαθαίνω, έμαθα, θα μάθω
2VgX8	Ελληνικά::Ρήματα::Исключения	живу, остаюсь	μένω, έμεινα, θα μείνω
"M#>6E"	Ελληνικά::Ρήματα::Исключения	беру	παίρνω, πήρα, θα πάρω
^db41	Ελληνικά::Ρήματα::Исключения	заказываю	παραγγέλνω, παράγγειλα, θα παραγγείλω
fD;}T	Ελληνικά::Ρήματα::Исключения	падаю	πέφτω, έπεσα, θα πέσω
Ij<wJ	Ελληνικά::Ρήματα::Исключения	мою, стираю	πλένω, έπλυνα, θα πλύνω
4MelK	Ελληνικά::Ρήματα::Исключения	отправляю	στέλνω, έστειλα, θα στείλω / αποστέλλω, απέστειλα, θα αποστείλω
`dL]8	Ελληνικά::Ρήματα::Исключения	ем	τρώω, έφαγα, θα φάω
CyZhA	Ελληνικά::Ρήματα::Исключения	приношу	φέρνω, έφερα, θα φέρω
pQ&0E	Ελληνικά::Ρήματα::Исключения	ухожу	φεύγω, έφυγα, θα φύγω
p^Bs3	Ελληνικά::Ρήματα::Исключения	вижу	βλέπω, είδα, θα δω
Ph=mF	Ελληνικά::Ρήματα::Исключения	говорю	λέω, είπα, θα πω
C!_BA	Ελληνικά::Ρήματα::Исключения	пью	πίνω, ήπια, θα πιω
h1qIE	Ελληνικά::Ρήματα::Исключения	вхожу	μπαίνω, μπήκα, θα μπω
.z6KS	Ελληνικά::Ρήματα::Исключения	выхожу	βγαίνω, βγήκα, θα βγω
?8xN4	Ελληνικά::Ρήματα::Исключения	нахожу	βρίσκω, βρήκα, θα βρω
wJJ0I	Ελληνικά::Ρήματα::Исключения	поднимаюсь	ανεβαίνω, ανέβηκα, θα ανεβώ
c4WtF	Ελληνικά::Ρήματα::Исключения	спускаюсь	κατεβαίνω, κατέβηκα, θα κατεβώ
.?GHS	Ελληνικά::Επίπεδο Α2::Έξω / На улице	рядом с	δίπλα στο
2`1l3	Ελληνικά::Επίπεδο Α2::Έξω / На улице	недалеко от	κοντά στο
BfWf4	Ελληνικά::Επίπεδο Α2::Έξω / На улице	далеко от	μακριά από
|wAGM	Ελληνικά::Επίπεδο Α2::Έξω / На улице	среди	ανάμεσα στο
~4qg6	Ελληνικά::Επίπεδο Α2::Έξω / На улице	напротив	απέναντι από
8nJBG	Ελληνικά::Επίπεδο Α2::Έξω / На улице	перед	μπροστά από 
upKLM	Ελληνικά::Επίπεδο Α2::Έξω / На улице	за чем-либо, позади	πίσω από
*ax!7	Ελληνικά::Επίπεδο Α2::Έξω / На улице	над чем-либо	πάνω από 
P<O]J	Ελληνικά::Επίπεδο Α2::Έξω / На улице	на чём-то	πάνω στο
,d^ZN	Ελληνικά::Επίπεδο Α2::Έξω / На улице	под чем-либо 	κάτω από 
_O6GK	Ελληνικά::Επίπεδο Α2::Έξω / На улице	снаружи	έξω από 
!*NO4	Ελληνικά::Επίπεδο Α2::Έξω / На улице	внутри	μέσα στο
a4SRK	Ελληνικά::Επίπεδο Α2::Έξω / На улице	иду прямо	προχωράω ευθεία 
y45]C	Ελληνικά::Επίπεδο Α2::Έξω / На улице	на углу	στη γωνία
Kc-CB	Ελληνικά::Επίπεδο Α2::Έξω / На улице	светофор	το φανάρι 
3f2K5	Ελληνικά::Επίπεδο Α2::Έξω / На улице	переходить напротив	περνάω απέναντι 
pT=rF	Ελληνικά::Επίπεδο Α2::Έξω / На улице	переулок / узкий	το στενό 
MW;fS	Ελληνικά::Επίπεδο Α2::Έξω / На улице	улица (разговорно)	ο δρόμος 
KzTz8	Ελληνικά::Επίπεδο Α2::Έξω / На улице	улица (официально)	η οδός 
6x$Z5	Ελληνικά::Επίπεδο Α2::Έξω / На улице	автомагистраль	ο αυτοκινητόδρομος
Z&NnO	Ελληνικά::Επίπεδο Α2::Έξω / На улице	повернуть налево	στρίβω αριστερά 
A/?;Q	Ελληνικά::Επίπεδο Α2::Έξω / На улице	повернуть направо	στρίβω δεξιά
0+nW7	Ελληνικά::Επίπεδο Α2::Σπίτι / Дом	первый/второй/третий/четвёртый/пятый этаж	πρώτος/δεύτερος/τρίτος/τέταρτος/πέμπτος όροφος
1qHGK	Ελληνικά::Επίπεδο Α2::Σπίτι / Дом	подвал / подвальный этаж	το υπόγειο
)=C~J	Ελληνικά::Επίπεδο Α2::Σπίτι / Дом	цокольный этаж	το ισόγειο 
Nj)x1	Ελληνικά::Επίπεδο Α2::Σπίτι / Дом	пентхаус 	το ρετιρέ
5&V+N	Ελληνικά::Επίπεδο Α2::Σπίτι / Дом	квартира	το διαμέρισμα 
is{,4	Ελληνικά::Επίπεδο Α2::Σπίτι / Дом	многоквартирный дом	η πολυκατοικία
RXN:D	Ελληνικά::Επίπεδο Α2::Σπίτι / Дом	одноквартирный дом	η μονοκατοικία
5LoyU	Ελληνικά::Επίπεδο Α2::Σπίτι / Дом	квартира-студия	το στούντιο / η γκαρσονιέρα
$SA9F	Ελληνικά::Επίπεδο Α2::Σπίτι / Дом	двушка (двухкомнатная квартира)	το δυάρι
hU8-P	Ελληνικά::Επίπεδο Α2::Σπίτι / Дом	трёшка (трёхкомнатная квартира)	το τριάρι
>@k*P	Ελληνικά::Επίπεδο Α2::Σπίτι / Дом	четырёхкомнатная квартира	το τεσσάρι
LpvrO	Ελληνικά::Επίπεδο Α2::Σπίτι / Дом	мезонет	η μεζονέτα
EzehS	Ελληνικά::Επίπεδο Α2::Σπίτι / Дом	кухня / кухонная плита	η κουζίνα
F{Y27	Ελληνικά::Επίπεδο Α2::Σπίτι / Дом	ванная комната	το μπάνιο
2&%k8	Ελληνικά::Επίπεδο Α2::Σπίτι / Дом	спальня	το υπνοδωμάτιο
GGksQ	Ελληνικά::Επίπεδο Α2::Σπίτι / Дом	столовая	η τραπεζαρία 
MZKM9	Ελληνικά::Επίπεδο Α2::Σπίτι / Дом	гостиная	το καθιστικό / το σαλόνι
1p]y7	Ελληνικά::Επίπεδο Α2::Σπίτι / Дом	коридор	ο διάδρομος
u{RaK	Ελληνικά::Επίπεδο Α2::Σπίτι / Дом	дверь	η πόρτα
PpdkE	Ελληνικά::Επίπεδο Α2::Σπίτι / Дом	окно	το παράθυρο
+v3CO	Ελληνικά::Επίπεδο Α2::Σπίτι / Дом	шкафчик	το ντουλάπι
}c0FL	Ελληνικά::Επίπεδο Α2::Σπίτι / Дом	ящик	το συρτάρι
[Hg/7	Ελληνικά::Επίπεδο Α2::Σπίτι / Дом	холодильник	το ψυγείο 
q{4-A	Ελληνικά::Επίπεδο Α2::Σπίτι / Дом	кухонная раковина	ο νεροχύτης
Jjl`O	Ελληνικά::Επίπεδο Α2::Σπίτι / Дом	кран с водой	η βρύση
ZO5l3	Ελληνικά::Επίπεδο Α2::Σπίτι / Дом	кровать	το κρεβάτι 
Jsoh6	Ελληνικά::Επίπεδο Α2::Σπίτι / Дом	тумбочка / комод	το κομοδίνο
vf7cE	Ελληνικά::Επίπεδο Α2::Σπίτι / Дом	шкаф	η ντουλάπα
QOfkS	Ελληνικά::Επίπεδο Α2::Σπίτι / Дом	зеркало	ο καθρέφτης
W}jtK	Ελληνικά::Επίπεδο Α2::Σπίτι / Дом	обеденный, праздничный стол	το τραπέζι 
EX*fU	Ελληνικά::Επίπεδο Α2::Σπίτι / Дом	стул	η καρέκλα 
1-$^1	Ελληνικά::Επίπεδο Α2::Σπίτι / Дом	письменный стол	το γραφείο 
)^&%	Ελληνικά::Επίπεδο Α2::Σπίτι / Дом	библиотека 	η βιβλιοθήκη
;$>uC	Ελληνικά::Επίπεδο Α2::Σπίτι / Дом	диван	ο καναπές / οι καναπέδες 
:jYaE	Ελληνικά::Επίπεδο Α2::Σπίτι / Дом	кресло	η πολυθρόνα
DcgsK	Ελληνικά::Επίπεδο Α2::Σπίτι / Дом	ковёр	το χαλί
;c6.A	Ελληνικά::Επίπεδο Α2::Σπίτι / Дом	светильник	το φωτιστικό
hPEwR	Ελληνικά::Επίπεδο Α2::Σπίτι / Дом	занавески	οι κουρτίνες
N,ChH	Ελληνικά::Επίπεδο Α2::Σπίτι / Дом	ванна	η μπανιέρα
`tnS3	Ελληνικά::Επίπεδο Α2::Σπίτι / Дом	стиральная машина	το πλυντήριο ρούχων
mlk=E	Ελληνικά::Επίπεδο Α2::Σπίτι / Дом	посудомоечная машина	το πλυντήριο πιατών
JrveU	Ελληνικά::Επίπεδο Α2::Σπίτι / Дом	раковина в ванной	ο νιπτήρας
O>3iL	Ελληνικά::Επίπεδο Α2::Σπίτι / Дом	унитаз	η λεκάνη τουαλέτας, η λεκάνη
K6%n}vJ2`b	Ελληνικά::Επίπεδο Α1::Τα χρώματα / τα ρούχα	куртка	το μπουφάν
"I0wO#&h9+%"	Ελληνικά::Επίπεδο Α1::Τα ζώα	свинья	το γουρούνι
tfZ;~C-2!@	Ελληνικά::Επίπεδο Α1::Τα επίθετα	хороший, красивый	ο ωραίος
dcaf=01&&;	Ελληνικά::Επίπεδο Α1::Τα χρώματα / τα ρούχα	бежевый	το μπεζ
F<FPdzy~Mw	Ελληνικά::Επίπεδο Α1::Ο καιρός	гроза (+глагол)	έχει καταιγίδα
AAZR^,k!VY	Ελληνικά::Επίπεδο Α1::Τα χρώματα / τα ρούχα	цвета	τα χρώματα
iU=sF)X6}n	Ελληνικά::Επίπεδο Α1::Τα χρώματα / τα ρούχα	сандалии, босоножки	τα πέδιλα
Pq?<alaItx	Ελληνικά::Επίπεδο Α1::Τα ζώα	зоопарк	ο ζωολογικός κήπος
t1s2uU|[Z`	Ελληνικά::Επίπεδο Α1::Ο καιρός	температура	η θερμοκρασία
gD@1t7:[/<	Ελληνικά::Επίπεδο Α1::Τα χρώματα / τα ρούχα	свитер	το πουλόβερ
D<ZL>:o&E3	Ελληνικά::Επίπεδο Α1::Ο καιρός	идёт дождь	βρέχει
ResK,P)/,8	Ελληνικά::Επίπεδο Α1::Τα χρώματα / τα ρούχα	оранжевый	το πορτοκαλί
y~;IP+>b4?	Ελληνικά::Επίπεδο Α1::Τα χρώματα / τα ρούχα	чёрный	το μαύρο
I11T`)TT_	Ελληνικά::Επίπεδο Α1::Τα επίθετα	старый	ο παλιός
mI|5Cr[G[0	Ελληνικά::Επίπεδο Α1::Τα ζώα	осёл	ο γάιδαρος
vrqZ7Pmb]	Ελληνικά::Επίπεδο Α1::Τα ζώα	черепаха	η χελώνα
r-M.z(Z7U[	Ελληνικά::Επίπεδο Α1::Τα ζώα	крокодил	ο κροκόδειλος
c]wYi+g,rT	Ελληνικά::Επίπεδο Α1::Τα χρώματα / τα ρούχα	нижнее бельё	τα εσώρουχα
DB1H]H`Ro>	Ελληνικά::Επίπεδο Α1::Τα επίθετα	дешёвый	φτηνός, φθηνός
p*$=NPX;%9	Ελληνικά::Επίπεδο Α1::Τα ζώα	кот, кошка	ο γάτος, η γάτα
hJV!bH_8qt	Ελληνικά::Επίπεδο Α1::Τα επίθετα	холодный	ο κρύος
JnqBG`3_mR	Ελληνικά::Επίπεδο Α1::Ο καιρός	плюс, минус	συν, πλην (μείον)
p+@}{r36]E	Ελληνικά::Επίπεδο Α1::Τα χρώματα / τα ρούχα	шарф	το κασκόλ
H57tS1FqmD	Ελληνικά::Επίπεδο Α1::Τα χρώματα / τα ρούχα	майка	το φανελάκι
h!}xB0d8[g	Ελληνικά::Επίπεδο Α1::Τα χρώματα / τα ρούχα	шапка	ο σκούφος
E11^0J)nSd	Ελληνικά::Επίπεδο Α1::Τα επίθετα	дорогой (про цену)	ακριβός
G;+[&pTJs:	Ελληνικά::Επίπεδο Α1::Τα ζώα	дельфин	το δελφίνι
cw1J?gt_[<	Ελληνικά::Επίπεδο Α1::Τα ζώα	овца	το πρόβατο
K/DsRcH[LP	Ελληνικά::Επίπεδο Α1::Τα ζώα	тигр	ο τίγρης
e*><O9e5n?	Ελληνικά::Επίπεδο Α1::Τα χρώματα / τα ρούχα	пальто	το παλτό
ecCjW=fW(_	Ελληνικά::Επίπεδο Α1::Το αξεσουάρ	крем для тела, лица, рук	η κρέμα σώματος, προσώπου, χεριών
qW$!-XnS.L	Ελληνικά::Επίπεδο Α1::Τα ζώα	верблюд	η καμήλα
"E-#b8,{@z^"	Ελληνικά::Επίπεδο Α1::Τα χρώματα / τα ρούχα	перчатки	τα γάντια
N+~raFJ-+D	Ελληνικά::Επίπεδο Α1::Τα ζώα	кролик	το κουνέλι
BE4<L662NP	Ελληνικά::Επίπεδο Α1::Τα επίθετα	этот, эта, это	αυτός ο, αυτή η, αυτό το
tuXj,wC{:D	Ελληνικά::Επίπεδο Α1::Τα χρώματα / τα ρούχα	голубой	το γαλάζιο
tbigMf;zyk	Ελληνικά::Επίπεδο Α1::Τα επίθετα	худой	ο λεπτός
l|a;=4hg0Z	Ελληνικά::Επίπεδο Α1::Τα χρώματα / τα ρούχα	жёлтый	το κίτρινο
Av[%Ia4T^)	Ελληνικά::Επίπεδο Α1::Τα επίθετα	весь, вся, всё, все	όλος ο, όλη η, όλο το, όλα τα, όλοι οι
rSvC40FFOQ	Ελληνικά::Επίπεδο Α1::Τα επίθετα	современный	ο μοντέρνος
v-Yo$ORxW:	Ελληνικά::Επίπεδο Α1::Τα ζώα	лошадь	το άλογο
"ohOu[i$I#/"	Ελληνικά::Επίπεδο Α1::Τα χρώματα / τα ρούχα	блузка	η μπλούζα
O*6*QCaS&+	Ελληνικά::Επίπεδο Α1::Ο καιρός	жара (+глагол)	έχει καύσωνα
b$LVN[eiq=	Ελληνικά::Επίπεδο Α1::Το αξεσουάρ	зонт	η ομπρέλα
gp$7kchLNP	Ελληνικά::Επίπεδο Α1::Τα ζώα	жираф	η καμηλοπάρδαλη
pyK(a0>lCy	Ελληνικά::Επίπεδο Α1::Τα χρώματα / τα ρούχα	серый	το γκρι
JKk%sR,$xc	Ελληνικά::Επίπεδο Α1::Ο καιρός	погода	ο καιρός
IG:ho@iG/!	Ελληνικά::Επίπεδο Α1::Το αξεσουάρ	пляжное полотенце	η πετσέτα (θαλασσής)
CP:q)j5%Hf	Ελληνικά::Επίπεδο Α1::Τα χρώματα / τα ρούχα	рубашка	το πουκάμισο
Jk|2B2I(F:	Ελληνικά::Επίπεδο Α1::Τα ζώα	корова	η αγελάδα
"GMI#A!Lqvp"	Ελληνικά::Επίπεδο Α1::Τα χρώματα / τα ρούχα	платье	το φόρεμα
k+JPTnPPx9	Ελληνικά::Επίπεδο Α1::Ο καιρός	жарко, холодно (+глагол)	κάνει κρύο, ζέστη
E7Y-=lDu`0	Ελληνικά::Επίπεδο Α1::Ο καιρός	влажность (+глагол)	έχει υγρασία
b6t97,d4W	Ελληνικά::Επίπεδο Α1::Τα χρώματα / τα ρούχα	купальник	το μαγιό
z5ZU,zVd~.	Ελληνικά::Επίπεδο Α1::Τα χρώματα / τα ρούχα	розовый	το ροζ
uFf1&Cf*b9	Ελληνικά::Επίπεδο Α1::Τα χρώματα / τα ρούχα	белый	το άσπρο
EqEVl,oSN4	Ελληνικά::Επίπεδο Α1::Το αξεσουάρ	аксессуар	το αξεσουάρ
O7h]G4g7:7	Ελληνικά::Επίπεδο Α1::Το αξεσουάρ	колье	το κολιέ
Q9_:N28}Np	Ελληνικά::Επίπεδο Α1::Τα ζώα	клетка	το κλουβί
J=X;wYW.8m	Ελληνικά::Επίπεδο Α1::Το αξεσουάρ	кольцо	το δαχτυλίδι
sp!A=/V=e~	Ελληνικά::Επίπεδο Α1::Ο καιρός	туман (+глагол)	έχει ομίχλη
tv7Ht)Pj<2	Ελληνικά::Επίπεδο Α1::Τα χρώματα / τα ρούχα	красный	το κόκκινο
K5C6yRSHlo	Ελληνικά::Επίπεδο Α1::Τα χρώματα / τα ρούχα	юбка	η φούστα
A^y^Nu{$K!	Ελληνικά::Επίπεδο Α1::Τα ζώα	животные	τα ζώα
k-v5xYZ,6r	Ελληνικά::Επίπεδο Α1::Τα χρώματα / τα ρούχα	тапочки	οι παντόφλες
bc^nqH6h|{	Ελληνικά::Επίπεδο Α1::Τα χρώματα / τα ρούχα	брюки, штаны	το παντελόνι
QpUA`B<-tQ	Ελληνικά::Επίπεδο Α1::Τα χρώματα / τα ρούχα	шляпа	το καπέλο
pmsXEa&J&m	Ελληνικά::Επίπεδο Α1::Τα χρώματα / τα ρούχα	фиолетовый	το μοβ
n(aj`9IbYs	Ελληνικά::Επίπεδο Α1::Το αξεσουάρ	ожерелье	το περιδέραιο
"IJ,4ST4#qo"	Ελληνικά::Επίπεδο Α1::Τα χρώματα / τα ρούχα	синий	το μπλε
fPiCV))]8s	Ελληνικά::Επίπεδο Α1::Τα επίθετα	молодой, молодая, молодое	νέος, νέα, νέο
eo9}wN[Lqh	Ελληνικά::Επίπεδο Α1::Το αξεσουάρ	косметика	τα καλλυντικά
mdCuX+L@d8	Ελληνικά::Επίπεδο Α1::Ο καιρός	идёт снег	χιονίζει
DwQ1x%F^)T	Ελληνικά::Επίπεδο Α1::Τα ζώα	обезьяна	η μαϊμού
dmUGb(e)Us	Ελληνικά::Επίπεδο Α1::Τα ζώα	собака (собачка)	ο σκύλος (το σκυλάκι)
EFKRwV]DD^	Ελληνικά::Επίπεδο Α1::Τα χρώματα / τα ρούχα	носки	οι κάλτσες
bl:l_ZDTUp	Ελληνικά::Επίπεδο Α1::Τα ζώα	утка	η πάπια
owPGj0/607	Ελληνικά::Επίπεδο Α1::Το αξεσουάρ	помада	το κραγιόν
z,Y>s-.o2J	Ελληνικά::Επίπεδο Α1::Το αξεσουάρ	солнечные очки	τα γυαλιά (ηλίου)
QsO@]7t}}E	Ελληνικά::Επίπεδο Α1::Τα επίθετα	высокий	ο ψηλός
l6c8s~J~jU	Ελληνικά::Επίπεδο Α1::Τα χρώματα / τα ρούχα	шорты	το σορτς
tO7,~XK0n=	Ελληνικά::Επίπεδο Α1::Τα επίθετα	новый	ο καινούριος
M=w3Ia2Tj,	Ελληνικά::Επίπεδο Α1::Τα χρώματα / τα ρούχα	одежда	τα ρούχα
I:$yp/k{k?	Ελληνικά::Επίπεδο Α1::Τα ζώα	птицы	τα πουλιά
fi^lYeUVX%	Ελληνικά::Επίπεδο Α1::Τα χρώματα / τα ρούχα	пиджак	το σακάκι
OHGN2}kJo<	Ελληνικά::Επίπεδο Α1::Τα επίθετα	толстый	ο χοντρός
hjkkg@G/DJ	Ελληνικά::Επίπεδο Α1::Τα χρώματα / τα ρούχα	костюм	το κοστούμι
Oks_-/fyBg	Ελληνικά::Επίπεδο Α1::Τα χρώματα / τα ρούχα	коричневый	το καφέ
r+!+OBBH`9	Ελληνικά::Επίπεδο Α1::Τα χρώματα / τα ρούχα	галстук	η γραβάτα
y;irgd@MYT	Ελληνικά::Επίπεδο Α1::Τα ζώα	курица (животное)	η κότα
OmT3S(]=?u	Ελληνικά::Επίπεδο Α1::Ο καιρός	град (+глагол)	κάνει χαλάζι
"fFaOZc{#%."	Ελληνικά::Επίπεδο Α1::Τα επίθετα	низкий	ο κοντός
EpV%PS-&wd	Ελληνικά::Επίπεδο Α1::Τα ζώα	слон	ο ελέφαντας
dnc{Ep.+C5	Ελληνικά::Επίπεδο Α1::Ο καιρός	солнечно (+глагол)	έχει ήλιο
ISBaZZnJ]=	Ελληνικά::Επίπεδο Α1::Το αξεσουάρ	сумка	η τσάντα
hM_[[@%/-,	Ελληνικά::Επίπεδο Α1::Το αξεσουάρ	ювелирные изделия	τα κοσμήματα
yx2!gNEBf/	Ελληνικά::Επίπεδο Α1::Τα χρώματα / τα ρούχα	обувь	τα παπούτσια
xyQ+Y8gSZJ	Ελληνικά::Επίπεδο Α1::Τα χρώματα / τα ρούχα	ботинки	οι μπότες
uk0y}.q2x@	Ελληνικά::Επίπεδο Α1::Τα χρώματα / τα ρούχα	колготки	το καλσόν
snVyYa$xae	Ελληνικά::Επίπεδο Α1::Τα επίθετα	тот, та, то	εκείνος ο, εκείνη η, εκείνο το
"iZp#Q4Y+7L"	Ελληνικά::Επίπεδο Α1::Το σούπερ μάρκετ / η υπεραγορά	таверна	η ταβέρνα
pTcy;ml-`z	Ελληνικά::Επίπεδο Α1::Τα επίθετα	маленький	ο μικρός
E%VzvTrV<C	Ελληνικά::Επίπεδο Α1::Το σούπερ μάρκετ / η υπεραγορά	колбаса, сосиски	το λουκάνικο
wIdz?cb?L+	Ελληνικά::Επίπεδο Α1::Το σούπερ μάρκετ / η υπεραγορά	соль	το αλάτι
H*S{L?b/kg	Ελληνικά::Επίπεδο Α1::Το σούπερ μάρκετ / η υπεραγορά	уксус	το ξίδι
bmpWocNlRM	Ελληνικά::Επίπεδο Α1::Οι μέρες / οι μήνες / οι εποχές του χρόνου	времена года	οι εποχές του χρόνου
gyAxgQ@!3}	Ελληνικά::Επίπεδο Α1::Τα μεταφορικά μέσα	транспортные средства	τα μεταφορικά μέσα
P[4l&3J;&q	Ελληνικά::Επίπεδο Α1::Το σούπερ μάρκετ / η υπεραγορά	сыр	το τυρί
Q;cs}^xq%?	Ελληνικά::Επίπεδο Α1::Το σούπερ μάρκετ / η υπεραγορά	макароны	τα μακαρόνια
G/kWPG%I-:	Ελληνικά::Επίπεδο Α1::Το σούπερ μάρκετ / η υπεραγορά	фарш	ο κιμάς
pFm~<+8!jA	Ελληνικά::Επίπεδο Α1::Το σούπερ μάρκετ / η υπεραγορά	кальмар	το καλαμάρι
AF.]z`<nd!	Ελληνικά::Επίπεδο Α1::Το σούπερ μάρκετ / η υπεραγορά	мука	το αλεύρι
drq*l-_5ah	Ελληνικά::Επίπεδο Α1::Το σούπερ μάρκετ / η υπεραγορά	пиво	η μπίρα
um[+mI:4&g	Ελληνικά::Επίπεδο Α1::Η οικογένεια	семейное положение	η οικογενειακή κατάσταση
EvW&U1TogI	Ελληνικά::Επίπεδο Α1::Το σούπερ μάρκετ / η υπεραγορά	сахар	η ζάχαρη
LF*&yL)8rt	Ελληνικά::Επίπεδο Α1::Το σούπερ μάρκετ / η υπεραγορά	рис	το ρύζι
ZjVe>|}wF	Ελληνικά::Επίπεδο Α1::Η λαϊκή / η φρουταρία / η λαχαναγορά	мандарины	τα μανταρίνια
"n=.H0Z|kf#"	Ελληνικά::Επίπεδο Α1::Η λαϊκή / η φρουταρία / η λαχαναγορά	овощи	τα λαχανικά
z+0fhMz,{Q	Ελληνικά::Επίπεδο Α1::Η λαϊκή / η φρουταρία / η λαχαναγορά	капуста (мн. ч.)	τα λάχανα
"cYo@PNUy#S"	Ελληνικά::Επίπεδο Α1::Η λαϊκή / η φρουταρία / η λαχαναγορά	дыни	τα πεπόνια
u=3R/_,.nj	Ελληνικά::Επίπεδο Α1::Το σούπερ μάρκετ / η υπεραγορά	рыба	το ψάρι
pHQxrUP*-p	Ελληνικά::Επίπεδο Α1::Η λαϊκή / η φρουταρία / η λαχαναγορά	бананы	οι μπανάνες
c_c4FSWp@C	Ελληνικά::Επίπεδο Α1::Οι μέρες / οι μήνες / οι εποχές του χρόνου	месяцы	οι μήνες
ji8sN;xvb7	Ελληνικά::Επίπεδο Α1::Η λαϊκή / η φρουταρία / η λαχαναγορά	салат-латук	τα μαρούλια
y:Jiy.C>N?	Ελληνικά::Επίπεδο Α1::Η λαϊκή / η φρουταρία / η λαχαναγορά	груши	τα αχλάδια
PZL9Y@7a`j	Ελληνικά::Επίπεδο Α1::Το σούπερ μάρκετ / η υπεραγορά	дорада	η τσιπούρα
zq,$`}P`^F	Ελληνικά::Επίπεδο Α1::Η λαϊκή / η φρουταρία / η λαχαναγορά	овощная лавка	η φρουταρία, το μανάβικο
v(N`v[CaN.	Ελληνικά::Επίπεδο Α1::Η λαϊκή / η φρουταρία / η λαχαναγορά	грамм, граммы	το γραμμάριο, τα γραμμάρια
cXU[kwVF9o	Ελληνικά::Επίπεδο Α1::Το σούπερ μάρκετ / η υπεραγορά	гель для душа	το αφρόλουτρο
d&g{ZBV.xi	Ελληνικά::Επίπεδο Α1::Η λαϊκή / η φρουταρία / η λαχαναγορά	яблоки	τα μήλα
wXiXv$@l3a	Ελληνικά::Επίπεδο Α1::Το σούπερ μάρκετ / η υπεραγορά	морской окунь (сибас)	το λαβράκι
HL:F~2{h2h	Ελληνικά::Επίπεδο Α1::Η λαϊκή / η φρουταρία / η λαχαναγορά	арбузы	τα καρπούζια
xvMc5J!zYv	Ελληνικά::Επίπεδο Α1::Οι εθνικότητες / οι γλώσσες	национальности	οι εθνικότητες
LGp.gO}(iH	Ελληνικά::Επίπεδο Α1::Η λαϊκή / η φρουταρία / η λαχαναγορά	тыква	η κολοκύθα
e0o.3hxM]k	Ελληνικά::Επίπεδο Α1::Οι εθνικότητες / οι γλώσσες	языки	οι γλώσσες
lcJre!4CO/	Ελληνικά::Επίπεδο Α1::Το σούπερ μάρκετ / η υπεραγορά	супермаркет	το σούπερ μάρκετ η υπεραγορά
D!su@~IzT>	Ελληνικά::Επίπεδο Α1::Το σούπερ μάρκετ / η υπεραγορά	говядина	το βοδινό
I9}Kz=o;tS	Ελληνικά::Επίπεδο Α1::Το σούπερ μάρκετ / η υπεραγορά	каракатица	η σουπιά
bS`k`JA8X;	Ελληνικά::Επίπεδο Α1::Το σούπερ μάρκετ / η υπεραγορά	курица	το κοτόπουλο
wOqdh3o~>W	Ελληνικά::Επίπεδο Α1::Η λαϊκή / η φρουταρία / η λαχαναγορά	вишни	τα κεράσια
E;vf&PT|]-	Ελληνικά::Επίπεδο Α1::Το σούπερ μάρκετ / η υπεραγορά	вещи для дома	πράγματα για το σπίτι
invnok.vRK	Ελληνικά::Επίπεδο Α1::Το σούπερ μάρκετ / η υπεραγορά	мясо	το κρέας
E(m|wEKgB?	Ελληνικά::Επίπεδο Α1::Το περίπτερο / ο φούρνος	пекарня	ο φούρνος
M_;{gQ;cBm	Ελληνικά::Επίπεδο Α1::Τα επίθετα	большой	ο μεγάλος
vTtWF`_:}N	Ελληνικά::Επίπεδο Α1::Το σούπερ μάρκετ / η υπεραγορά	осьминог	το χταπόδι
rJQZH2d0-H	Ελληνικά::Επίπεδο Α1::Το σούπερ μάρκετ / η υπεραγορά	раковины (морские)	τα όστρακα
jEs&h/r2B5	Ελληνικά::Επίπεδο Α1::Η λαϊκή / η φρουταρία / η λαχαναγορά	кабачки	τα κολοκυθάκια
gn^iD.kRC+	Ελληνικά::Επίπεδο Α1::Το σούπερ μάρκετ / η υπεραγορά	чечевица	οι φακές
e%8dho$_DW	Ελληνικά::Επίπεδο Α1::Η λαϊκή / η φρουταρία / η λαχαναγορά	баклажаны	οι μελιτζάνες
e%&Vg1&aXy	Ελληνικά::Επίπεδο Α1::Η λαϊκή / η φρουταρία / η λαχαναγορά	морковь	τα καρότα
n<~QnPxGDp	Ελληνικά::Επίπεδο Α1::Το περίπτερο / ο φούρνος	киоск	το περίπτερο
y6@WERvuVN	Ελληνικά::Επίπεδο Α1::Το σούπερ μάρκετ / η υπεραγορά	зубная щётка	η οδοντόβουρτσα
f{31@>1cUx	Ελληνικά::Επίπεδο Α1::Το σούπερ μάρκετ / η υπεραγορά	масло сливочное	το βούτυρο
AY[x:DGx^X	Ελληνικά::Επίπεδο Α1::Το σούπερ μάρκετ / η υπεραγορά	вино (белое, красное)	το κρασί (λευκό, άσπρο / ερυθρό, κόκκινο)
O`B~${8ANF	Ελληνικά::Επίπεδο Α1::Το σούπερ μάρκετ / η υπεραγορά	салфетки (для стола, еды)	οι χαρτοπετσέτες
ohNhzWn=H[	Ελληνικά::Επίπεδο Α1::Το σούπερ μάρκετ / η υπεραγορά	фасоль	τα φασόλια
t?IP+U>5kS	Ελληνικά::Επίπεδο Α1::Το σούπερ μάρκετ / η υπεραγορά	креветки	οι γαρίδες
FG.jtDzh.U	Ελληνικά::Επίπεδο Α1::Οι μέρες / οι μήνες / οι εποχές του χρόνου	дни	οι μέρες
HSt*)_:4;0	Ελληνικά::Επίπεδο Α1::Το σούπερ μάρκετ / η υπεραγορά	яйца	τα αυγά
yj{=1f$D;M	Ελληνικά::Επίπεδο Α1::Η λαϊκή / η φρουταρία / η λαχαναγορά	апельсины	τα πορτοκάλια
exECK9uA&1	Ελληνικά::Επίπεδο Α1::Το σούπερ μάρκετ / η υπεραγορά	омар	ο αστακός
l(~`l4Sck1	Ελληνικά::Επίπεδο Α1::Τα επίθετα	хороший, хорошая, хорошее	ο καλός, η καλή, το καλό
CRi,A+Ol}j	Ελληνικά::Επίπεδο Α1::Το σούπερ μάρκετ / η υπεραγορά	мидии	τα μύδια
mbb?l|{V9W	Ελληνικά::Επίπεδο Α1::Τα επίθετα	уродливый	ο άσχημος
Jk}7BYWQCV	Ελληνικά::Επίπεδο Α1::Το σούπερ μάρκετ / η υπεραγορά	ресторан	το εστιατόριο
"I{ZdJSF#|X"	Ελληνικά::Επίπεδο Α1::Τα επίθετα	плохой, плохая,  плохое	κακός, κακή, κακό
IH=?A<X[]v	Ελληνικά::Επίπεδο Α1::Η λαϊκή / η φρουταρία / η λαχαναγορά	чеснок	το σκόρδο
vU5OXlgUM(	Ελληνικά::Επίπεδο Α1::Το σούπερ μάρκετ / η υπεραγορά	туалетная бумага	το χαρτί υγείας
dx;jMARl>g	Ελληνικά::Επίπεδο Α1::Τα επίθετα	прилагательные	τα επίθετα
Q|6x^A!;vV	Ελληνικά::Επίπεδο Α1::Το σούπερ μάρκετ / η υπεραγορά	телятина, телячье мясо	το μοσχάρι, το μοσχαρίσιο κρέας
C1gUvSsJ-g	Ελληνικά::Επίπεδο Α1::Το σούπερ μάρκετ / η υπεραγορά	мыло	το σαπούνι
FCMMyL2vBo	Ελληνικά::Επίπεδο Α1::Η λαϊκή / η φρουταρία / η λαχαναγορά	перцы	οι πιπεριές
GD3Mue.R);	Ελληνικά::Επίπεδο Α1::Η λαϊκή / η φρουταρία / η λαχαναγορά	томаты	οι ντομάτες
m|w{eDod8;	Ελληνικά::Επίπεδο Α1::Τα επαγγέλματα	профессии	τα επαγγέλματα
"v!tc:,t<S#"	Ελληνικά::Επίπεδο Α1::Το σούπερ μάρκετ / η υπεραγορά	масло растительное	το λάδι
CRAA;I{iBS	Ελληνικά::Επίπεδο Α1::Το σούπερ μάρκετ / η υπεραγορά	еда и напитки	τρόφιμα και ποτά
A)/KY?UigB	Ελληνικά::Επίπεδο Α1::Η λαϊκή / η φρουταρία / η λαχαναγορά	фрукты	τα φρούτα
k^.Iva@m1K	Ελληνικά::Επίπεδο Α1::Το σούπερ μάρκετ / η υπεραγορά	свинина	το χοιρινό
Q21/K@5iZk	Ελληνικά::Επίπεδο Α1::Τα επίθετα	красивый	ο όμορφος
Pg5(uv,Y6_	Ελληνικά::Επίπεδο Α1::Η λαϊκή / η φρουταρία / η λαχαναγορά	огурцы	τα αγγούρια
DUr?qs>.)p	Ελληνικά::Επίπεδο Α1::Η λαϊκή / η φρουταρία / η λαχαναγορά	овощной рынок	η λαχαναγορά
LUm39Um).5	Ελληνικά::Επίπεδο Α1::Το σούπερ μάρκετ / η υπεραγορά	шампунь для волос	το σαμπουάν μαλλιών
kJ/4v*Sx_e	Ελληνικά::Επίπεδο Α1::Η λαϊκή / η φρουταρία / η λαχαναγορά	картофель	οι πατάτες
p&w<NY)gk	Ελληνικά::Επίπεδο Α1::Η λαϊκή / η φρουταρία / η λαχαναγορά	городской рынок	η λαϊκή (αγορά)
N>Z=mA(|R8	Ελληνικά::Επίπεδο Α1::Η λαϊκή / η φρουταρία / η λαχαναγορά	петрушка	ο μαϊντανός
Ls/8Rpp}0(	Ελληνικά::Επίπεδο Α1::Η λαϊκή / η φρουταρία / η λαχαναγορά	лук	τα κρεμμύδια
PYr<pY,n$@	Ελληνικά::Επίπεδο Α1::Η λαϊκή / η φρουταρία / η λαχαναγορά	персики	τα ροδάκινα
"F9D+=#3%%v"	Ελληνικά::Επίπεδο Α1::Η λαϊκή / η φρουταρία / η λαχαναγορά	абрикосы	τα βερίκοκα
hG+[;DIpXB	Ελληνικά::Επίπεδο Α1::Η λαϊκή / η φρουταρία / η λαχαναγορά	клубника	οι φράουλες
sF;cx?,Rj|	Ελληνικά::Επίπεδο Α1::Η λαϊκή / η φρουταρία / η λαχαναγορά	килограмм, килограммы	το κιλό, τα κιλά
Dd4Mdf|@.@	Ελληνικά::Επίπεδο Α1::Η λαϊκή / η φρουταρία / η λαχαναγορά	укроп	ο άνηθος
lW]}*W7gao	Ελληνικά::Επίπεδο Α1::Η λαϊκή / η φρουταρία / η λαχαναγορά	виноград	τα σταφύλια
lZ~cvcF&F&	Ελληνικά::Επίπεδο Α1::Το σούπερ μάρκετ / η υπεραγορά	морепродукты	τα θαλασσινά
e$k~O%Z.>r	Ελληνικά::Επίπεδο Α1::Το σούπερ μάρκετ / η υπεραγορά	барабуля	το μπαρμπούνι
PsL)I2}R~]	Ελληνικά::Επίπεδο Α1::Το σούπερ μάρκετ / η υπεραγορά	кондиционер для волос	το μαλακτικό μαλλιών
HF6g?3a>fX	Ελληνικά::Επίπεδο Α1::Το περίπτερο / ο φούρνος	сладости	τα γλυκά
"q,S_!%d#f-"	Ελληνικά::Επίπεδο Α1::Το σούπερ μάρκετ / η υπεραγορά	моющее средство (для одежды, посуды, дома)	το απορρυπαντικό (για τα ρούχα, για τα πιάτα, για το σπίτι)
Ofw{G^be=f	Ελληνικά::Επίπεδο Α1::Το σούπερ μάρκετ / η υπεραγορά	зубная паста	η οδοντόκρεμα
J|$nOZN}({	Ελληνικά::Επίπεδο Α1::Η οικογένεια	семья	η οικογένεια
h`0WOeW<I.	Ελληνικά::Επίπεδο Α1::Οι μέρες / οι μήνες / οι εποχές του χρόνου	февраль	ο Φεβρουάριος
fe|O9~|[<L	Ελληνικά::Επίπεδο Α1::Οι μέρες / οι μήνες / οι εποχές του χρόνου	май	ο Μάιος
F(0{,*nig5	Ελληνικά::Επίπεδο Α1::Οι εθνικότητες / οι γλώσσες	швейцарец, швейцарка	ο Ελβετός, η Ελβετίδα
q!@JO44!8Q	Ελληνικά::Επίπεδο Α1::Τα μεταφορικά μέσα	трамвай	το τραμ
b7/7NMq3!S	Ελληνικά::Επίπεδο Α1::Το περίπτερο / ο φούρνος	билет на автобус	το εισιτήριο για το λεωφορείο
o-cYkEA^SJ	Ελληνικά::Επίπεδο Α1::Οι μέρες / οι μήνες / οι εποχές του χρόνου	зима	ο χειμώνας
e~(Ny)eFLy	Ελληνικά::Επίπεδο Α1::Πόσο συχνά; Κάθε πότε;	часто	συχνά
o*`k-!^>*_	Ελληνικά::Επίπεδο Α1::Το περίπτερο / ο φούρνος	чипсы	τα πατατάκια
y*z6vHIN=;	Ελληνικά::Επίπεδο Α1::Το περίπτερο / ο φούρνος	хлеб	το ψωμί
K1Yn@rqvk=	Ελληνικά::Επίπεδο Α1::Το περίπτερο / ο φούρνος	вода	το νερό
Qtp>|8;=;t	Ελληνικά::Επίπεδο Α1::Τα επαγγέλματα	повар, повариха	ο μάγειρας, η μαγείρισσα
m[!=GZ^ExI	Ελληνικά::Επίπεδο Α1::Τα μεταφορικά μέσα	электричка	ο ηλεκτρικός
MX%f5VR.Zj	Ελληνικά::Επίπεδο Α1::Οι μέρες / οι μήνες / οι εποχές του χρόνου	июнь	ο Ιούνιος
idB_]_Eg?1	Ελληνικά::Επίπεδο Α1::Τα επαγγέλματα	спортсмен, спортсменка	ο αθλητής, η αθλήτρια
zI$iAIS-BO	Ελληνικά::Επίπεδο Α1::Πόσο συχνά; Κάθε πότε;	обычно	συνήθως
jCTo`Io!I6	Ελληνικά::Επίπεδο Α1::Τα επαγγέλματα	секретарь	ο/η γραμματέας
rGk/0pG41w	Ελληνικά::Επίπεδο Α1::Πόσο συχνά; Κάθε πότε;	иногда	μερικές φορές καμιά φορά κάπου κάπου πότε πότε
nSMi@db~2c	Ελληνικά::Επίπεδο Α1::Οι εθνικότητες / οι γλώσσες	английский (язык)	τα Αγγλικά
"dk7V#JL~Mx"	Ελληνικά::Επίπεδο Α1::Το περίπτερο / ο φούρνος	йогурт	το γιαούρτι
GzHsVxYG7]	Ελληνικά::Επίπεδο Α1::Το περίπτερο / ο φούρνος	карандаш	το μολύβι
GMo%Bna@RN	Ελληνικά::Επίπεδο Α1::Οι μέρες / οι μήνες / οι εποχές του χρόνου	пятница	η Παρασκευή
gJL^Gx|`=v	Ελληνικά::Επίπεδο Α1::Οι μέρες / οι μήνες / οι εποχές του χρόνου	апрель	ο Απρίλιος
lszc6HB|Cc	Ελληνικά::Επίπεδο Α1::Το περίπτερο / ο φούρνος	бублик	το κουλούρι
My~JxQuw@8	Ελληνικά::Επίπεδο Α1::Το περίπτερο / ο φούρνος	сырный пирог	η τυρόπιτα
xX),H8vV3C	Ελληνικά::Επίπεδο Α1::Τα επαγγέλματα	работник, работница	ο εργάτης, η εργάτρια
M`6d)@Y;D.	Ελληνικά::Επίπεδο Α1::Πόσο συχνά; Κάθε πότε;	почти всегда	σχεδόν πάντα
"l_1Q[X>6R#"	Ελληνικά::Επίπεδο Α1::Τα μεταφορικά μέσα	автомобиль	το αυτοκίνητο
r36*(Tw]zZ	Ελληνικά::Επίπεδο Α1::Το περίπτερο / ο φούρνος	мороженое	το παγωτό
c+B/3P)>M>	Ελληνικά::Επίπεδο Α1::Το περίπτερο / ο φούρνος	сэндвич	το σάντουιτς
*rh>MNB)4	Ελληνικά::Επίπεδο Α1::Τα επαγγέλματα	официант, официантка	ο σερβιτόρος, η σερβιτόρα
n[@4U_>4]<	Ελληνικά::Επίπεδο Α1::Οι μέρες / οι μήνες / οι εποχές του χρόνου	осень	το φθινόπωρο
o2.({qa~ZC	Ελληνικά::Επίπεδο Α1::Τα επαγγέλματα	сотрудник	ο/η υπάλληλος
nj:Av?9ug^	Ελληνικά::Επίπεδο Α1::Οι μέρες / οι μήνες / οι εποχές του χρόνου	март	ο Μάρτιος
Q|D0-W9b95	Ελληνικά::Επίπεδο Α1::Το περίπτερο / ο φούρνος	сок	ο χυμός
bI*zRNLo<X	Ελληνικά::Επίπεδο Α1::Το περίπτερο / ο φούρνος	тосты-сухари (выпечка)	οι φρυγανιές
kYD6$_`^~q	Ελληνικά::Επίπεδο Α1::Το περίπτερο / ο φούρνος	журнал	το περιοδικό
KvpS+|9x<0	Ελληνικά::Επίπεδο Α1::Το περίπτερο / ο φούρνος	молоко	το γάλα
xn@f+|u>&g	Ελληνικά::Επίπεδο Α1::Οι μέρες / οι μήνες / οι εποχές του χρόνου	октябрь	ο Οκτώβριος
DMUHxE3|=y	Ελληνικά::Επίπεδο Α1::Τα μεταφορικά μέσα	такси	το ταξί
P,(Su>Vf=H	Ελληνικά::Επίπεδο Α1::Το περίπτερο / ο φούρνος	круасан	το κρουασάν
l<jLv.L5_-	Ελληνικά::Επίπεδο Α1::Οι εθνικότητες / οι γλώσσες	украинец, украинка	ο Ουκρανός, η Ουκρανή
eZa,eT4(;D	Ελληνικά::Επίπεδο Α1::Πόσο συχνά; Κάθε πότε;	никогда	ποτέ δε(ν)
%D4Y&WZT{	Ελληνικά::Επίπεδο Α1::Τα μεταφορικά μέσα	авария, несчастный случай	το ατύχημα
Jn<nf0m)B@	Ελληνικά::Επίπεδο Α1::Οι εθνικότητες / οι γλώσσες	испанский (язык)	τα Ισπανικά
j+];6|RvyB	Ελληνικά::Επίπεδο Α1::Οι μέρες / οι μήνες / οι εποχές του χρόνου	суббота	το Σάββατο
GVw?7UU35Y	Ελληνικά::Επίπεδο Α1::Το περίπτερο / ο φούρνος	жвачки	οι τσίχλες
w.jHErDeuq	Ελληνικά::Επίπεδο Α1::Οι μέρες / οι μήνες / οι εποχές του χρόνου	июль	ο Ιούλιος
re+jTF7Eno	Ελληνικά::Επίπεδο Α1::Τα μεταφορικά μέσα	велосипед	το ποδήλατο
rFQ-}OiQ4T	Ελληνικά::Επίπεδο Α1::Τα επαγγέλματα	актёр	ο/η ηθοποιός
PC^Rk>7~!H	Ελληνικά::Επίπεδο Α1::Πόσο συχνά; Κάθε πότε;	много раз	πολλές φορές
E?0}]?9|(1	Ελληνικά::Επίπεδο Α1::Τα επαγγέλματα	архитектор	ο/η αρχιτέκτονας
oVqgf0+S;$	Ελληνικά::Επίπεδο Α1::Τα μεταφορικά μέσα	автобус	το λεωφορείο
"roh(B~Usv#"	Ελληνικά::Επίπεδο Α1::Τα επαγγέλματα	учитель, учительница	ο δάσκαλος, η δασκάλα
rr+M%EF-^3	Ελληνικά::Επίπεδο Α1::Οι μέρες / οι μήνες / οι εποχές του χρόνου	понедельник	η Δευτέρα
Jk~+6oiP>p	Ελληνικά::Επίπεδο Α1::Τα επαγγέλματα	продавец, продавщица	ο πωλητής, η πωλήτρια
Edu7K_K>-D	Ελληνικά::Επίπεδο Α1::Το περίπτερο / ο φούρνος	шпинатный пирог	η σπανακόπιτα
c:),|%n|6e	Ελληνικά::Επίπεδο Α1::Οι εθνικότητες / οι γλώσσες	русский (язык)	τα Ρωσικά
"k^,#FV!:%$"	Ελληνικά::Επίπεδο Α1::Το περίπτερο / ο φούρνος	ручка	το στιλό
"nwLJ%u#Do<"	Ελληνικά::Επίπεδο Α1::Οι μέρες / οι μήνες / οι εποχές του χρόνου	весна	η άνοιξη
"G=!}{(y#Rc"	Ελληνικά::Επίπεδο Α1::Τα επαγγέλματα	водитель	ο/η οδηγός
oLa](!i3|]	Ελληνικά::Επίπεδο Α1::Το περίπτερο / ο φούρνος	печенье, которое макают в напиток	τα βουτήματα (τα μπισκότα)
OSN:cjSHS(	Ελληνικά::Επίπεδο Α1::Οι μέρες / οι μήνες / οι εποχές του χρόνου	ноябрь	ο Νοέμβριος
pBv2QPgp!A	Ελληνικά::Επίπεδο Α1::Οι μέρες / οι μήνες / οι εποχές του χρόνου	январь	ο Ιανουάριος
yOf;b?2r5b	Ελληνικά::Επίπεδο Α1::Τα επαγγέλματα	врач	ο/η γιατρός
MmH-U&6c,,	Ελληνικά::Επίπεδο Α1::Οι μέρες / οι μήνες / οι εποχές του χρόνου	среда	η Τετάρτη
D``8Cq:<ti	Ελληνικά::Επίπεδο Α1::Οι μέρες / οι μήνες / οι εποχές του χρόνου	воскресенье	η Κυριακή
wAniQTJ{J^	Ελληνικά::Επίπεδο Α1::Οι μέρες / οι μήνες / οι εποχές του χρόνου	выходные	το Σαββατοκύριακο
emV!Ee1>)O	Ελληνικά::Επίπεδο Α1::Το περίπτερο / ο φούρνος	шоколадка	η σοκολάτα
jZJ1Q>hRDm	Ελληνικά::Επίπεδο Α1::Πόσο συχνά; Κάθε πότε;	всегда	πάντα
ol4B?r]{x8	Ελληνικά::Επίπεδο Α1::Οι μέρες / οι μήνες / οι εποχές του χρόνου	четверг	η Πέμπτη
OB}zmKB?H+	Ελληνικά::Επίπεδο Α1::Οι μέρες / οι μήνες / οι εποχές του χρόνου	декабрь	ο Δεκέμβριος
h4/mf<L6CP	Ελληνικά::Επίπεδο Α1::Το περίπτερο / ο φούρνος	бумажные платочки	τα χαρτομάντιλα
elj!**xcX-	Ελληνικά::Επίπεδο Α1::Οι μέρες / οι μήνες / οι εποχές του χρόνου	вторник	η Τρίτη
k&,)$](-ss	Ελληνικά::Επίπεδο Α1::Τα επαγγέλματα	медбрат, медсестра	ο νοσοκόμος, η νοσοκόμα
w`m9IX*)7t	Ελληνικά::Επίπεδο Α1::Πόσο συχνά; Κάθε πότε;	каждый день	κάθε μέρα
jEF&.DdD/)	Ελληνικά::Επίπεδο Α1::Οι εθνικότητες / οι γλώσσες	украинский (язык)	τα Ουκρανικά
gsp[UJ*l&a	Ελληνικά::Επίπεδο Α1::Το περίπτερο / ο φούρνος	палочки (выпечка)	τα κριτσίνια
Ij0|,v5;vC	Ελληνικά::Επίπεδο Α1::Οι μέρες / οι μήνες / οι εποχές του χρόνου	август	ο Αύγουστος
GsoZJN+`6	Ελληνικά::Επίπεδο Α1::Τα επαγγέλματα	адвокат	ο/η δικηγόρος
A%RD%aS-j7	Ελληνικά::Επίπεδο Α1::Οι μέρες / οι μήνες / οι εποχές του χρόνου	сентябрь	ο Σεπτέμβριος
J=)JaTe~]`	Ελληνικά::Επίπεδο Α1::Τα επαγγέλματα	кассир	ο/η ταμίας
zd_oH}`-]n	Ελληνικά::Επίπεδο Α1::Τα μεταφορικά μέσα	двигатель, мотоцикл	η μηχανή
@!n/x<=3]	Ελληνικά::Επίπεδο Α1::Οι εθνικότητες / οι γλώσσες	русский, русская	ο Ρώσος, η Ρωσίδα
E?>`hwbjO+	Ελληνικά::Επίπεδο Α1::Τα μεταφορικά μέσα	метро	το μετρό
Na:lv>qLS~	Ελληνικά::Επίπεδο Α1::Οι εθνικότητες / οι γλώσσες	турок, турчанка	ο Τούρκος, η Τουρκάλα
gu}GESe=jM	Ελληνικά::Επίπεδο Α1::Το περίπτερο / ο φούρνος	газета	η εφημερίδα
ieUVMk@jj7	Ελληνικά::Επίπεδο Α1::Οι εθνικότητες / οι γλώσσες	испанец, испанка	ο Ισπανός, η Ισπανίδα
D<]fr%M5I*	Ελληνικά::Επίπεδο Α1::Το περίπτερο / ο φούρνος	газировка	το αναψυκτικό
ur;E5emaYO	Ελληνικά::Επίπεδο Α1::Τα επαγγέλματα	безработный, безработная	ο άνεργος, η άνεργη
r5Ti|}q1p@	Ελληνικά::Επίπεδο Α1::Τα μεταφορικά μέσα	троллейбус	το τρόλεϊ
krVGN6_>BU	Ελληνικά::Επίπεδο Α1::Τα επαγγέλματα	инженер	ο/η μηχανικός
JbM]q8$(fA	Ελληνικά::Επίπεδο Α1::Τα επαγγέλματα	электрик	ο/η ηλεκτρολόγος
o40xH-njR8	Ελληνικά::Επίπεδο Α1::Το περίπτερο / ο φούρνος	конфеты	οι καραμέλες
d-ar!kA2ju	Ελληνικά::Επίπεδο Α1::Οι εθνικότητες / οι γλώσσες	турецкий (язык)	τα Τουρκικά
LQ0|D_|QEo	Ελληνικά::Επίπεδο Α1::Οι εθνικότητες / οι γλώσσες	китаец, китаянка	ο Κινέζος, η Κινέζα
xrSM6i;t7_	Ελληνικά::Επίπεδο Α1::Οι εθνικότητες / οι γλώσσες	греческий (язык)	τα Ελληνικά
cRd%e9rB~S	Ελληνικά::Επίπεδο Α1::Οι εθνικότητες / οι γλώσσες	грек, гречанка	ο Έλληνας, η Ελληνίδα
xd@yz5S<B=	Ελληνικά::Επίπεδο Α1::Οι μέρες / οι μήνες / οι εποχές του χρόνου	лето	το καλοκαίρι
N:po]*4U,@	Ελληνικά::Επίπεδο Α1::Πόσο συχνά; Κάθε πότε;	редко	σπάνια
p?pKU96UR7	Ελληνικά::Επίπεδο Α1::Η οικογένεια	мальчик	το αγόρι
Dgq@Zp<MyD	Ελληνικά::Επίπεδο Α1::Η οικογένεια	внучка	η εγγονή
cM{(ctQqwZ	Ελληνικά::Επίπεδο Α1::Η οικογένεια	внук	ο εγγονός
g),|r.75xG	Ελληνικά::Επίπεδο Α1::Η οικογένεια	свободен, свободна	ελεύθερος, ελεύθερη
E4m-C@Ve0_	Ελληνικά::Επίπεδο Α1::Η οικογένεια	родители	οι γονείς
"k/#-]@W%vN"	Ελληνικά::Επίπεδο Α1::Η οικογένεια	дети, ребята	τα παιδιά
sXQS,Rq<,Q	Ελληνικά::Επίπεδο Α1::Η οικογένεια	девочка	το κορίτσι
A[x8A~H*1t	Ελληνικά::Επίπεδο Α1::Η οικογένεια	папа (отец)	ο μπαμπάς (πατέρας)
h((=N9*[kM	Ελληνικά::Επίπεδο Α1::Η οικογένεια	сестра	η αδελφή
nc=a%/$A|S	Ελληνικά::Επίπεδο Α1::Η οικογένεια	женат, замужем	ο παντρεμένος, η παντρεμένη
r}Tl6:$+Of	Ελληνικά::Επίπεδο Α1::Η οικογένεια	мама (мать)	η μαμά (η μητέρα)
h%na4M_ilO	Ελληνικά::Επίπεδο Α1::Η οικογένεια	брат	ο αδελφός
K;8G>@TW>P	Ελληνικά::Επίπεδο Α1::Η οικογένεια	дочь	η κόρη
zjxZ~fgtj2	Ελληνικά::Επίπεδο Α1::Η οικογένεια	двоюродный брат	ο ξάδελφος
LO$!@m?59?	Ελληνικά::Επίπεδο Α1::Η οικογένεια	племянник	ο ανιψιός
P`<ZDs}8!c	Ελληνικά::Επίπεδο Α1::Τα επαγγέλματα	профессор	ο καθηγητής / η καθηγήτρια
"hIM.J}#(BB"	Ελληνικά::Επίπεδο Α1::Η οικογένεια	разведён, разведена	ο χωρισμένος, η χωρισμένη
Bk=gfRTZml	Ελληνικά::Επίπεδο Α1::Η οικογένεια	бабушка	η γιαγιά
I5>`/Q],oN	Ελληνικά::Επίπεδο Α1::Η οικογένεια	дядя	ο θείος
eqL1y}*<QD	Ελληνικά::Επίπεδο Α1::Η οικογένεια	братья	τα αδέλφια
NPm^q`mNiv	Ελληνικά::Επίπεδο Α1::Η οικογένεια	ребёнок	το παιδί
PYj?gg*NrH	Ελληνικά::Επίπεδο Α1::Η οικογένεια	племянница	η ανιψιά
"N-{X|.#1^n"	Ελληνικά::Επίπεδο Α1::Η οικογένεια	сын	ο γιος
Qp$mbqwQw3	Ελληνικά::Επίπεδο Α1::Η οικογένεια	дедушка	ο παππούς
na+c15/w@e	Ελληνικά::Επίπεδο Α1::Τα επαγγέλματα	студент, студентка	ο φοιτητής, η φοιτήτρια
xF},IT=H=5	Ελληνικά::Επίπεδο Α1::Η οικογένεια	двоюродная сестра	η ξαδέλφη
gEh$yPKf>n	Ελληνικά::Επίπεδο Α1::Η οικογένεια	тётя	η θεία
nFN[HqY)17	Ελληνικά::Επίπεδο Α1::Τα επαγγέλματα	парикмахер	ο κομμωτής / η κομμώτρια
2EN;9	Ελληνικά::Επίπεδο Α2::Οι γιορτές / Праздники	день рождения 	τα γενέθλια 
!b~o7	Ελληνικά::Επίπεδο Α2::Οι γιορτές / Праздники	именины	η ονομαστική γιορτή
4v15P	Ελληνικά::Επίπεδο Α2::Οι γιορτές / Праздники	торт	η τούρτα
&r:OQ	Ελληνικά::Επίπεδο Α2::Οι γιορτές / Праздники	вечеринка	το πάρτυ
A.MZE	Ελληνικά::Επίπεδο Α2::Οι γιορτές / Праздники	друзья	οι φίλοι
,]aJB	Ελληνικά::Επίπεδο Α2::Οι γιορτές / Праздники	накрывать на стол (устраивать застолье)	κάνω τραπέζι 
=dZSM	Ελληνικά::Επίπεδο Α2::Οι γιορτές / Праздники	звать друзей	καλώ φίλους 
mtH.8	Ελληνικά::Επίπεδο Α2::Οι γιορτές / Праздники	подарок	το δώρο
bu4^G	Ελληνικά::Επίπεδο Α2::Οι γιορτές / Праздники	с днём рождения (долгих лет)	χρόνια πολλά 
^0_`S	Ελληνικά::Επίπεδο Α2::Οι γιορτές / Праздники	да здравствуй, здравствуйте (пожелание)	να ζήσεις, να ζήσετε
V90e6	Ελληνικά::Επίπεδο Α2::Οι γιορτές / Праздники	свадебное платье 	το νυφικό
&*OuP	Ελληνικά::Επίπεδο Α2::Οι γιορτές / Праздники	брак	ο γάμος
.dIl9	Ελληνικά::Επίπεδο Α2::Οι γιορτές / Праздники	крестины	τα βαφτίσια 
=jFoR	Ελληνικά::Επίπεδο Α2::Οι γιορτές / Праздники	жених	ο γαμπρός 
~T;S9	Ελληνικά::Επίπεδο Α2::Οι γιορτές / Праздники	невеста	η νύφη
+N/ZD	Ελληνικά::Επίπεδο Α2::Οι γιορτές / Праздники	крёстный	ο νονός
L$|:C	Ελληνικά::Επίπεδο Α2::Οι γιορτές / Праздники	крёстная	η νονά
@)*7B	Ελληνικά::Επίπεδο Α2::Οι γιορτές / Праздники	крестник / крестница	ο βαφτιστικός / η βαφτιστικιά
{S3(6	Ελληνικά::Επίπεδο Α2::Οι γιορτές / Праздники	церковь	η εκκλησία 
)z^WN	Ελληνικά::Επίπεδο Α2::Οι γιορτές / Праздники	праздничный стол	το τραπέζι 
NufJH	Ελληνικά::Επίπεδο Α2::Οι γιορτές / Праздники	удовольствие / веселье	η διασκέδαση 
2Gh+P	Ελληνικά::Επίπεδο Α2::Οι γιορτές / Праздники	традиция	η παράδοση
NJAHD	Ελληνικά::Επίπεδο Α2::Οι γιορτές / Праздники	хорошее время (пожелание, благословление)	η ώρα η καλή
s<$FP	Ελληνικά::Επίπεδο Α2::Ο κινηματογράφος (το σινεμά) / Кино	жанры кино	τα είδη ταινιών
BT.gE	Ελληνικά::Επίπεδο Α2::Ο κινηματογράφος (το σινεμά) / Кино	показ, сеанс	η προβολή
a2W~N	Ελληνικά::Επίπεδο Α2::Ο κινηματογράφος (το σινεμά) / Кино	часы показа	οι ώρες προβολής
FT{L2	Ελληνικά::Επίπεδο Α2::Ο κινηματογράφος (το σινεμά) / Кино	комедия	η κωμωδία
QcQjH	Ελληνικά::Επίπεδο Α2::Ο κινηματογράφος (το σινεμά) / Кино	приключение	η περιπέτεια 
IaL:5	Ελληνικά::Επίπεδο Α2::Ο κινηματογράφος (το σινεμά) / Кино	исторический фильм	η ιστορική ταινία 
"N#?&H"	Ελληνικά::Επίπεδο Α2::Ο κινηματογράφος (το σινεμά) / Кино	социальный фильм	η κοινωνική ταινία
=7zwI	Ελληνικά::Επίπεδο Α2::Ο κινηματογράφος (το σινεμά) / Кино	фильм ужасов / триллер	η ταινία τρόμου / το θρίλερ 
%vGv1	Ελληνικά::Επίπεδο Α2::Ο κινηματογράφος (το σινεμά) / Кино	мультфильмы	τα κινούμενα σχέδια 
j+s=T	Ελληνικά::Επίπεδο Α2::Ο κινηματογράφος (το σινεμά) / Кино	новости	τα νέα / οι ειδήσεις 
&vFv6	Ελληνικά::Επίπεδο Α2::Ο κινηματογράφος (το σινεμά) / Кино	документальный фильм 	το ντοκιμαντέρ
G`JbD	Ελληνικά::Επίπεδο Α2::Το άθλημα (το σπορ) / Спорт	бег	το τρέξιμο
+DOAO	Ελληνικά::Επίπεδο Α2::Το άθλημα (το σπορ) / Спорт	плавание 	η κολύμβηση
zBZj2	Ελληνικά::Επίπεδο Α2::Το άθλημα (το σπορ) / Спорт	альпинизм	η ορειβασία
lm.<1	Ελληνικά::Επίπεδο Α2::Το άθλημα (το σπορ) / Спорт	ходьба	το περπάτημα 
0SN|8	Ελληνικά::Επίπεδο Α2::Το άθλημα (το σπορ) / Спорт	водные виды спорта	τα θαλάσσια σπορ
w4ZTI	Ελληνικά::Επίπεδο Α2::Το άθλημα (το σπορ) / Спорт	гимнастика	η γυμναστική 
YJY7	Ελληνικά::Επίπεδο Α2::Το άθλημα (το σπορ) / Спорт	йога	η γιόγκα
&6orU	Ελληνικά::Επίπεδο Α2::Το άθλημα (το σπορ) / Спорт	тренажёрный зал	το γυμναστήριο 
y=CA	Ελληνικά::Επίπεδο Α2::Το άθλημα (το σπορ) / Спорт	тренировка 	η προπόνηση 
D(FMB	Ελληνικά::Επίπεδο Α2::Το άθλημα (το σπορ) / Спорт	тренер	ο προπονητής, η προπονήτρια
Y+od5	Ελληνικά::Επίπεδο Α2::Το άθλημα (το σπορ) / Спорт	танец	ο χορός 
m;n*O	Ελληνικά::Επίπεδο Α2::Το άθλημα (το σπορ) / Спорт	баскетбол 	το μπάσκετ
v{t*T	Ελληνικά::Επίπεδο Α2::Το άθλημα (το σπορ) / Спорт	футбол	το ποδόσφαιρο 
f$RoL	Ελληνικά::Επίπεδο Α2::Το άθλημα (το σπορ) / Спорт	волейбол 	το βόλεϊ
6Krz4	Ελληνικά::Επίπεδο Α2::Το άθλημα (το σπορ) / Спорт	команда	η ομάδα 
:ART3	Ελληνικά::Επίπεδο Α2::Το άθλημα (το σπορ) / Спорт	стадион	το γήπεδο / το στάδιο 
A[;9C	Ελληνικά::Επίπεδο Α2::Το άθλημα (το σπορ) / Спорт	болельщики	οι οπαδοί
tuR}L	Ελληνικά::Επίπεδο Α2::Η μουσική / Музыка	классическая музыка 	η κλασική μουσική
j{ldQ	Ελληνικά::Επίπεδο Α2::Η μουσική / Музыка	джаз	η τζαζ
)YkcR	Ελληνικά::Επίπεδο Α2::Η μουσική / Музыка	традиционная музыка 	η παραδοσιακή μουσική
eheCP	Ελληνικά::Επίπεδο Α2::Η μουσική / Музыка	народная музыка 	η λαϊκή μουσική
Pg|2J	Ελληνικά::Επίπεδο Α2::Η μουσική / Музыка	художественная, интеллектуальная музыка	η έντεχνη μουσική
ULCJB	Ελληνικά::Επίπεδο Α2::Η μουσική / Музыка	ребетика (греческий блатняк 20-30 годов)	το ρεμπέτικο
?V]*6	Ελληνικά::Επίπεδο Α2::Η μουσική / Музыка	концерт	η συναυλία
wGzNH	Ελληνικά::Επίπεδο Α2::Η μουσική / Музыка	опера	η όπερα
"sFA#R"	Ελληνικά::Επίπεδο Α2::Η μουσική / Музыка	песня	το τραγούδι
`L;~H	Ελληνικά::Επίπεδο Α2::Η μουσική / Музыка	певец / певица	ο τραγουδιστής / η τραγουδίστρια
BUgk7	Ελληνικά::Επίπεδο Α2::Η μουσική / Музыка	музыкальные инструменты 	τα μουσικά όργανα 
(7z{I	Ελληνικά::Επίπεδο Α2::Η μουσική / Музыка	пианино	το πιάνο 
kih)O	Ελληνικά::Επίπεδο Α2::Η μουσική / Музыка	гитара	η κιθάρα 
!g>*8	Ελληνικά::Επίπεδο Α2::Η μουσική / Музыка	хор	η χορωδία 
e&:zE	Ελληνικά::Επίπεδο Α2::Το θέατρο / Театр	драматический театр	το δραματικό θέατρο 
3*:pL	Ελληνικά::Επίπεδο Α2::Το θέατρο / Театр	балет	το μπαλέτο
,%@{5	Ελληνικά::Επίπεδο Α2::Το θέατρο / Театр	дневное представление / вечерний спектакль	η απογευματινή παράσταση / η βραδινή παράσταση
,d?{Q	Ελληνικά::Επίπεδο Α2::Το θέατρο / Театр	обычный / льготный билет	το κανονικό / το μειωμένο εισιτήριο 
0yesC	Ελληνικά::Επίπεδο Α2::Το θέατρο / Театр	публика	το κοινό
1<Kv9	Ελληνικά::Επίπεδο Α2::Το θέατρο / Театр	зрители 	οι θεατές
4RoW2	Ελληνικά::Επίπεδο Α2::Το θέατρο / Театр	таверна с живой музыкой 	η ταβέρνα με ζωντανή μουσική 
T^D}L	Ελληνικά::Επίπεδο Α2::Το θέατρο / Театр	развлекательный центр	το κέντρο διασκέδασης 
&mNLT	Ελληνικά::Επίπεδο Α2::Το θέατρο / Театр	бузуки (греческая лютня)	το μπουζούκι
r%zPM	Ελληνικά::Επίπεδο Α2::Το θέατρο / Театр	выставка	η έκθεση
9SvK5	Ελληνικά::Επίπεδο Α2::Το θέατρο / Театр	фотография	η φωτογραφία 
4q[|1	Ελληνικά::Επίπεδο Α2::Το θέατρο / Театр	фестиваль 	το φεστιβάλ 
;2!=L	Ελληνικά::Επίπεδο Α2::Το θέατρο / Театр	хорошо проведите время	καλή διασκέδαση / καλά να περάσετε
;6VYB	Ελληνικά::Επίπεδο Α2::Το ταξίδι (ο τουρίσμος) / Путешествие (туризм)	пассажир	ο επιβάτης
O1h19	Ελληνικά::Επίπεδο Α2::Το ταξίδι (ο τουρίσμος) / Путешествие (туризм)	экскурсия / тур	η εκδρομή 
VZs.A	Ελληνικά::Επίπεδο Α2::Το ταξίδι (ο τουρίσμος) / Путешествие (туризм)	круиз	η κρουαζιέρα
/+7jS	Ελληνικά::Επίπεδο Α2::Το ταξίδι (ο τουρίσμος) / Путешествие (туризм)	маршрут	το δρομολόγιο
:<igC	Ελληνικά::Επίπεδο Α2::Το ταξίδι (ο τουρίσμος) / Путешествие (туризм)	отправление	η αναχώρηση
m<-wB	Ελληνικά::Επίπεδο Α2::Το ταξίδι (ο τουρίσμος) / Путешествие (туризм)	прибытие	η άφιξη
H-XQS	Ελληνικά::Επίπεδο Α2::Το ταξίδι (ο τουρίσμος) / Путешествие (туризм)	корабль	το πλοίο 
(vYiA	Ελληνικά::Επίπεδο Α2::Το ταξίδι (ο τουρίσμος) / Путешествие (туризм)	самолёт 	το αεροπλάνο
rxQ_J	Ελληνικά::Επίπεδο Α2::Το ταξίδι (ο τουρίσμος) / Путешествие (туризм)	забронировать билеты	κλείνω εισιτήρια
1(|K	Ελληνικά::Επίπεδο Α2::Το ταξίδι (ο τουρίσμος) / Путешествие (туризм)	бронировать	κάνω κράτηση
4oW62	Ελληνικά::Επίπεδο Α2::Το ταξίδι (ο τουρίσμος) / Путешествие (туризм)	виза	η βίζα
ybfOR	Ελληνικά::Επίπεδο Α2::Το ταξίδι (ο τουρίσμος) / Путешествие (туризм)	турагентство 	το ταξιδιωτικό γραφείο / το τουριστικό πρακτορείο
cuEhO	Ελληνικά::Επίπεδο Α2::Το ταξίδι (ο τουρίσμος) / Путешествие (туризм)	турпакет	το οργανωμένο ταξίδι / το πακέτο
d=v;A	Ελληνικά::Επίπεδο Α2::Το ταξίδι (ο τουρίσμος) / Путешествие (туризм)	отель двух/трёх/четырёх/пятизвёздочный 	 το ξενοδοχείο δύο/τριών/τεσσάρων/πέντε αστέρων
i%.22	Ελληνικά::Επίπεδο Α2::Το ταξίδι (ο τουρίσμος) / Путешествие (туризм)	завтрак включён	με πρωινό
?cEjQ	Ελληνικά::Επίπεδο Α2::Το ταξίδι (ο τουρίσμος) / Путешествие (туризм)	с полупансионом (частичным питанием)	με ημιδιατροφή
1;E+O	Ελληνικά::Επίπεδο Α2::Το ταξίδι (ο τουρίσμος) / Путешествие (туризм)	с полным пансионом (питанием)	με πλήρη διατροφή
BV/AA	Ελληνικά::Επίπεδο Α2::Το ταξίδι (ο τουρίσμος) / Путешествие (туризм)	номер в отеле	το δωμάτιο
+GPM	Ελληνικά::Επίπεδο Α2::Το ταξίδι (ο τουρίσμος) / Путешествие (туризм)	одноместный номер	το μονόκλινο
t_XXK	Ελληνικά::Επίπεδο Α2::Το ταξίδι (ο τουρίσμος) / Путешествие (туризм)	двухместный номер	το δίκλινο
k_6BI	Ελληνικά::Επίπεδο Α2::Το ταξίδι (ο τουρίσμος) / Путешествие (туризм)	трёхместный номер	το τρίκλινο
9/o@5	Ελληνικά::Επίπεδο Α2::Το ταξίδι (ο τουρίσμος) / Путешествие (туризм)	арендованная комната	το ενοικιαζόμενο δωμάτιο 
l*r[F	Ελληνικά::Επίπεδο Α2::Το ταξίδι (ο τουρίσμος) / Путешествие (туризм)	кемпинг	το κάμπινγκ
pyaY6	Ελληνικά::Επίπεδο Α2::Το επάγγελμα (η δουλειά) / Профессия (работа)	биографические данные (резюме)	το βιογραφικό σημείωμα 
M;UC9	Ελληνικά::Επίπεδο Α2::Το επάγγελμα (η δουλειά) / Профессия (работа)	имя	το όνομα 
oM%RF	Ελληνικά::Επίπεδο Α2::Το επάγγελμα (η δουλειά) / Профессия (работа)	фамилия 	το επώνυμο
m2V<T	Ελληνικά::Επίπεδο Α2::Το επάγγελμα (η δουλειά) / Профессия (работа)	полное имя	το ονοματεπώνυμο
cr]xG	Ελληνικά::Επίπεδο Α2::Το επάγγελμα (η δουλειά) / Профессия (работа)	адрес	η διεύθυνση 
]H,v9	Ελληνικά::Επίπεδο Α2::Το επάγγελμα (η δουλειά) / Профессия (работа)	дата рождения	η ημερομηνία γέννησης
%k&PK	Ελληνικά::Επίπεδο Α2::Το επάγγελμα (η δουλειά) / Профессия (работа)	образование	οι σπουδές
moz&B	Ελληνικά::Επίπεδο Α2::Το επάγγελμα (η δουλειά) / Профессия (работа)	иностранные языки 	οι ξένες γλώσσες 
$H<OD	Ελληνικά::Επίπεδο Α2::Το επάγγελμα (η δουλειά) / Профессия (работа)	опыт / предыдущие места работы	η εμπειρία /η προϋπηρεσία
RLpX2	Ελληνικά::Επίπεδο Α2::Το επάγγελμα (η δουλειά) / Профессия (работа)	знания	οι γνώσεις 
>8]FE	Ελληνικά::Επίπεδο Α2::Το επάγγελμα (η δουλειά) / Профессия (работа)	интересы	τα ενδιαφέροντα 
yL7CC	Ελληνικά::Επίπεδο Α2::Το επάγγελμα (η δουλειά) / Профессия (работа)	постоянная должность 	η μόνιμη/σταθερή θέση
~X6iI	Ελληνικά::Επίπεδο Α2::Το επάγγελμα (η δουλειά) / Профессия (работа)	временная должность	η προσωρινή θέση
(A]m7	Ελληνικά::Επίπεδο Α2::Το επάγγελμα (η δουλειά) / Профессия (работа)	должность на неполный рабочий день	η θέση μερικής απασχόλησης
YLTcF	Ελληνικά::Επίπεδο Α2::Το επάγγελμα (η δουλειά) / Профессия (работа)	трудовой договор / контракт	η σύμβαση εργασίας / το συμβόλαιο
iee$M	Ελληνικά::Επίπεδο Α2::Το επάγγελμα (η δουλειά) / Профессия (работа)	работодатель / начальница / босс	ο εργοδότης / η εργοδότρια / το αφεντικό 
tAhEP	Ελληνικά::Επίπεδο Α2::Το επάγγελμα (η δουλειά) / Профессия (работа)	директор / директриса	ο διευθυντής / η διευθύντρια
|pjWO	Ελληνικά::Επίπεδο Α2::Το επάγγελμα (η δουλειά) / Профессия (работа)	компания (работа)	η εταιρεία 
g|<hP	Ελληνικά::Επίπεδο Α2::Το επάγγελμα (η δουλειά) / Профессия (работа)	сотрудник (сотрудница)	ο/η υπάλληλος / εργαζόμενος
`)6_1	Ελληνικά::Επίπεδο Α2::Το επάγγελμα (η δουλειά) / Профессия (работа)	коллега	ο/η συνάδελφος 
j<A9E	Ελληνικά::Επίπεδο Α2::Το επάγγελμα (η δουλειά) / Профессия (работа)	график работы	το ωράριο
UzA6K	Ελληνικά::Επίπεδο Α2::Το επάγγελμα (η δουλειά) / Профессия (работа)	сверхурочная работа	η υπερωρία
U7vgJ	Ελληνικά::Επίπεδο Α2::Το επάγγελμα (η δουλειά) / Профессия (работа)	лицензия, отпуск	η άδεια
1iBBU	Ελληνικά::Επίπεδο Α2::Το επάγγελμα (η δουλειά) / Профессия (работа)	выходной	η αργία
M8.vL	Ελληνικά::Επίπεδο Α2::Το επάγγελμα (η δουλειά) / Профессия (работа)	подневная оплата	το μεροκάματο
49z@E	Ελληνικά::Επίπεδο Α2::Το επάγγελμα (η δουλειά) / Профессия (работа)	брутто-доход (гросс, ЗП грязными)	τα μεικτά
T[e9F	Ελληνικά::Επίπεδο Α2::Το επάγγελμα (η δουλειά) / Профессия (работа)	чистая ЗП	τα καθαρά 
NMGqU	Ελληνικά::Επίπεδο Α2::Το επάγγελμα (η δουλειά) / Профессия (работа)	пенсия	η σύνταξη
9:rRA	Ελληνικά::Επίπεδο Α2::Το επάγγελμα (η δουλειά) / Профессия (работа)	бронирования	οι κρατήσεις
9r,L8	Ελληνικά::Επίπεδο Α2::Το επάγγελμα (η δουλειά) / Профессия (работа)	марки (за страховые взносы)	τα ένσημα
T{2sJ	Ελληνικά::Επίπεδο Α2::Το επάγγελμα (η δουλειά) / Профессия (работа)	повышение	η αύξηση
2MICQ	Ελληνικά::Επίπεδο Α2::Το επάγγελμα (η δουλειά) / Профессия (работа)	безработица 	η ανεργία
4u=0L	Ελληνικά::Επίπεδο Α2::Το επάγγελμα (η δουλειά) / Профессия (работа)	забастовка 	η απεργία
n>ruP	Ελληνικά::Επίπεδο Α2::Το επάγγελμα (η δουλειά) / Профессия (работа)	карьера	η καριέρα / η σταδιοδρομία 
5V)4O	Ελληνικά::Επίπεδο Α2::Το επάγγελμα (η δουλειά) / Профессия (работа)	поздравления	τα συγχαρητήρια
hsfzB	Ελληνικά::Επίπεδο Α2::Το σώμα / Тело	тело	το σώμα
/QO2B	Ελληνικά::Επίπεδο Α2::Το σώμα / Тело	голова	το κεφάλι
z1KWN	Ελληνικά::Επίπεδο Α2::Το σώμα / Тело	лоб	το μέτωπο
AK=q2	Ελληνικά::Επίπεδο Α2::Το σώμα / Тело	щека	το μάγουλο
jr612	Ελληνικά::Επίπεδο Α2::Το σώμα / Тело	глаза	τα μάτια
L0KWT	Ελληνικά::Επίπεδο Α2::Το σώμα / Тело	нос	η μύτη
A|7j4	Ελληνικά::Επίπεδο Α2::Το σώμα / Тело	рот	το στόμα 
SN=PJ	Ελληνικά::Επίπεδο Α2::Το σώμα / Тело	губы	τα χείλια
I?*8O	Ελληνικά::Επίπεδο Α2::Το σώμα / Тело	уши	τα αυτιά
c$:fL	Ελληνικά::Επίπεδο Α2::Το σώμα / Тело	шея, горло	ο λαιμός
,{V<7	Ελληνικά::Επίπεδο Α2::Το σώμα / Тело	плечо	ο ώμος
aR0+C	Ελληνικά::Επίπεδο Α2::Το σώμα / Тело	грудь	το στήθος
}Mti5	Ελληνικά::Επίπεδο Α2::Το σώμα / Тело	живот	η κοιλιά
]c,CD	Ελληνικά::Επίπεδο Α2::Το σώμα / Тело	талия	η μέση
1EFdJ	Ελληνικά::Επίπεδο Α2::Το σώμα / Тело	спина	η πλάτη 
9G>|J	Ελληνικά::Επίπεδο Α2::Το σώμα / Тело	руки	τα χέρια
sKS`N	Ελληνικά::Επίπεδο Α2::Το σώμα / Тело	локоть	ο αγκώνας 
^0<d5	Ελληνικά::Επίπεδο Α2::Το σώμα / Тело	ладонь	η παλάμη
%?S_U	Ελληνικά::Επίπεδο Α2::Το σώμα / Тело	пальцы рук	τα δάχτυλα των χεριών
frdDO	Ελληνικά::Επίπεδο Α2::Το σώμα / Тело	пальцы ног	τα δάχτυλα των ποδιών
va6N9	Ελληνικά::Επίπεδο Α2::Το σώμα / Тело	ноги	τα πόδια
uZG9A	Ελληνικά::Επίπεδο Α2::Το σώμα / Тело	колени	τα γόνατα
,p1`1	Ελληνικά::Επίπεδο Α2::Οι γιατροί / Врачи	стоматолог	ο οδοντίατρος
^r3iF	Ελληνικά::Επίπεδο Α2::Οι γιατροί / Врачи	ортопед	ο ορθοπεδικός
&eD14	Ελληνικά::Επίπεδο Α2::Οι γιατροί / Врачи	окулист	ο οφθαλμίατρος
8QgrN	Ελληνικά::Επίπεδο Α2::Οι γιατροί / Врачи	отоларинголог (лор)	ο ωτορινολαρυγγολόγος 
vnn:J	Ελληνικά::Επίπεδο Α2::Οι γιατροί / Врачи	гинеколог	ο γυναικολόγος
>Gv=6	Ελληνικά::Επίπεδο Α2::Οι γιατροί / Врачи	патолог	ο παθολόγος
2!*=7	Ελληνικά::Επίπεδο Α2::Οι γιατροί / Врачи	педиатр	ο παιδίατρος
jKS1O	Ελληνικά::Επίπεδο Α2::Οι γιατροί / Врачи	рентгенолог	ο ακτινολόγος
r.Ys4	Ελληνικά::Επίπεδο Α2::Οι γιατροί / Врачи	дерматолог	ο δερματολόγος
=:-?H	Ελληνικά::Επίπεδο Α2::Οι γιατροί / Врачи	микробиолог	ο μικροβιολόγος
1QBSF	Ελληνικά::Επίπεδο Α2::Οι γιατροί / Врачи	кардиолог	ο καρδιολόγος
{-(5K	Ελληνικά::Επίπεδο Α2::Οι γιατροί / Врачи	хирург	ο χειρούργος 
0HS6S	Ελληνικά::Επίπεδο Α2::Οι γιατροί / Врачи	психиатр	ο ψυχίατρος
;]&kS	Ελληνικά::Επίπεδο Α2::Ασθένειες / Болезнь	пациент / пациентка	ο/η ασθενής
qf)}U	Ελληνικά::Επίπεδο Α2::Ασθένειες / Болезнь	больной / больная	ο άρρωστος / η άρρωστη
&i{8I	Ελληνικά::Επίπεδο Α2::Ασθένειες / Болезнь	простужен / простужена / простудился / у меня простуда	είμαι κρυωμένος / κρυωμένη / κρύωσα / έχω κρυολόγημα
.*{*H	Ελληνικά::Επίπεδο Α2::Ασθένειες / Болезнь	у меня грипп	έχω γρίπη
&^B,U	Ελληνικά::Επίπεδο Α2::Ασθένειες / Болезнь	у меня температура (высокая), лихорадка	έχω πυρετό
_|(WF	Ελληνικά::Επίπεδο Α2::Ασθένειες / Болезнь	у меня температура (невысокая)	έχω δέκατα
-;!wR	Ελληνικά::Επίπεδο Α2::Ασθένειες / Болезнь	у меня насморк	έχω συνάχι
n:SZ2	Ελληνικά::Επίπεδο Α2::Ασθένειες / Болезнь	у меня сопли	τρέχει η μύτη μου
}hLIL	Ελληνικά::Επίπεδο Α2::Ασθένειες / Болезнь	кашляю	βήχω, έβηξα, θα βήξω
<X%RK	Ελληνικά::Επίπεδο Α2::Ασθένειες / Болезнь	чихаю	φταρνίζομαι, φταρνίστηκα, θα φταρνιστώ
v)qL7	Ελληνικά::Επίπεδο Α2::Ασθένειες / Болезнь	болит голова	πονάει το κεφάλι μου / έχω πονοκέφαλο
w?q67	Ελληνικά::Επίπεδο Α2::Ασθένειες / Болезнь	озноб, кружится голова	έχω ρίγη, ζαλίζομαι
])0cU	Ελληνικά::Επίπεδο Α2::Ασθένειες / Болезнь	я сломал руку	έσπασα το χέρι μου
Jwv>A	Ελληνικά::Επίπεδο Α2::Ασθένειες / Болезнь	у меня аллергия 	έχω αλλεργία
P-j.K	Ελληνικά::Επίπεδο Α2::Ασθένειες / Болезнь	поставить градусник 	βάζω  θερμόμετρο
!lxfC	Ελληνικά::Επίπεδο Α2::Ασθένειες / Болезнь	идти к врачу	πηγαίνω στον γιατρό
up/Z5	Ελληνικά::Επίπεδο Α2::Ασθένειες / Болезнь	записаться на приём к врачу 	κλείνω ραντεβού στον γιατρό 
_nc|J	Ελληνικά::Επίπεδο Α2::Ασθένειες / Болезнь	сдать общие анализы крови и мочи	κάνω γενικές εξετάσεις αίματος και ούρων
O5!V8	Ελληνικά::Επίπεδο Α2::Ασθένειες / Болезнь	врач выписывает рецепт	ο γιατρός γράφει μία συνταγή
6:Zx1	Ελληνικά::Επίπεδο Α2::Ασθένειες / Болезнь	принимать антибиотики	παίρνω αντιβίωση / αντιβιοτικά
oS8/I	Ελληνικά::Επίπεδο Α2::Ασθένειες / Болезнь	сироп (одна столовая ложка)	το σιρόπι (μία κουταλιά της σούπας)
oTOvB	Ελληνικά::Επίπεδο Α2::Ασθένειες / Болезнь	обезболивающие	τα παυσίπονα
[Oz^	Ελληνικά::Επίπεδο Α2::Ασθένειες / Болезнь	жаропонижающие	τα αντιπυρετικά
U`<-3	Ελληνικά::Επίπεδο Α2::Ασθένειες / Болезнь	леденцы для горла	οι καραμέλες για τον λαιμό
qd$Z4	Ελληνικά::Επίπεδο Α2::Ασθένειες / Болезнь	делать укол	κάνω ένεση
=o:>3	Ελληνικά::Επίπεδο Α2::Ασθένειες / Болезнь	делать прививку	κάνω εμβόλιο
[7-<4	Ελληνικά::Επίπεδο Α2::Ασθένειες / Болезнь	капать глазные капли	βάζω κολλύριο
cI>fI	Ελληνικά::Επίπεδο Α2::Ασθένειες / Болезнь	наносить мазь	βάζω αλοιφή
c>)aE	Ελληνικά::Επίπεδο Α2::Η τράπεζα / Банк	открыть счёт 	ανοίγω λογαριασμό
h^eC3	Ελληνικά::Επίπεδο Α2::Η τράπεζα / Банк	касса	το ταμείο
mNyc2	Ελληνικά::Επίπεδο Α2::Η τράπεζα / Банк	в банкомате	στην αυτόματη ταμειακή μηχανή (ΑΤΜ)
Yh.TJ	Ελληνικά::Επίπεδο Α2::Η τράπεζα / Банк	пополнение / снятие	η κατάθεση / η ανάληψη
~EpqO	Ελληνικά::Επίπεδο Α2::Η τράπεζα / Банк	внести деньги на депозит	καταθέτω χρήματα
S,@L4	Ελληνικά::Επίπεδο Α2::Η τράπεζα / Банк	снимать деньги	κάνω μία ανάληψη
/DdKO	Ελληνικά::Επίπεδο Α2::Η τράπεζα / Банк	получать кредит	παίρνω δάνειο
i&%`T	Ελληνικά::Επίπεδο Α2::Η τράπεζα / Банк	оплачивать счета / аренду / налоги	πληρώνω λογαριασμούς / το ενοίκειο / την εφορία
|9jeM	Ελληνικά::Επίπεδο Α2::Η τράπεζα / Банк	налоговая декларация 	η φορολογική δήλωση
3V+1N	Ελληνικά::Επίπεδο Α2::Η τράπεζα / Банк	менять валюту	κάνω συνάλλαγμα
b9jnP	Ελληνικά::Επίπεδο Α2::Η τράπεζα / Банк	обналичивать чеки	εξαργυρώνω επιταγές
yjlr2	Ελληνικά::Επίπεδο Α2::Η τράπεζα / Банк	доставать дебетовую/кредитную карту	βγάζω μία ανάληψης/πιστωτική καρτα
<2i[O	Ελληνικά::Επίπεδο Α2::Η τράπεζα / Банк	кредит	το δάνειο
aijG3	Ελληνικά::Επίπεδο Α2::Το ταχυδρομείο / Почта	письмо (простое / экспресс / регистрируемое отправление)	η επιστολή / το γράμμα (απλό / εξπρές / συστημένο)
XnSHD	Ελληνικά::Επίπεδο Α2::Το ταχυδρομείο / Почта	открытка	η κάρτα
7xL]K	Ελληνικά::Επίπεδο Α2::Το ταχυδρομείο / Почта	упаковка	το δέμα
"|Q##E"	Ελληνικά::Επίπεδο Α2::Το ταχυδρομείο / Почта	факс	το φαξ
,o$kN	Ελληνικά::Επίπεδο Α2::Το ταχυδρομείο / Почта	почтовые чеки	οι ταχυδρομικές επιταγές
m&<_6	Ελληνικά::Επίπεδο Α2::Το ταχυδρομείο / Почта	по стране	το εσωτερικό 
E0aNN	Ελληνικά::Επίπεδο Α2::Το ταχυδρομείο / Почта	международные отправления	το εξωτερικό 
3h~p6	Ελληνικά::Επίπεδο Α2::Το ταχυδρομείο / Почта	штемпель / почтовая марка 	το γραμματόσημο
o]P]M	Ελληνικά::Επίπεδο Α2::Το ταχυδρομείο / Почта	конверт	ο φάκελος
Ps_?U	Ελληνικά::Επίπεδο Α2::Το ταχυδρομείο / Почта	отправитель	ο αποστολέας
"1q/#"	Ελληνικά::Επίπεδο Α2::Το ταχυδρομείο / Почта	получатель	ο παραλήπτης
160/6	Ελληνικά::Επίπεδο Α2::Η αστυνομία / Полиция	удостоверение личности, подлинность	η ταυτότητα 
BBD;K	Ελληνικά::Επίπεδο Α2::Η αστυνομία / Полиция	подтверждение подлинности документов / подлинности подписи	επικυρώνω έγγραφα / το γνήσιο της υπογραφής
o~D=T	Ελληνικά::Επίπεδο Α2::Η αστυνομία / Полиция	ксерокопия / копия	η φωτοτυπία / το αντίγραφο
|(MdE	Ελληνικά::Επίπεδο Α2::Η αστυνομία / Полиция	оригинал	το πρωτότυπο
s@hzI	Ελληνικά::Επίπεδο Α2::Η αστυνομία / Полиция	происшествие / чрезвычайная ситуация	η περίπτωση / η κατάσταση ανάγκης
MXNaR	Ελληνικά::Επίπεδο Α2::Η αστυνομία / Полиция	кража	η κλοπή
I%!Q9	Ελληνικά::Επίπεδο Α2::Η αστυνομία / Полиция	потеря	η απώλεια
4~cYO	Ελληνικά::Επίπεδο Α2::Η άδεια διαμονής, το πολιτικό άσυλο / ВНЖ, политическое убежище	подтверждающие документы	το δικαιολογητικά
P?I4L	Ελληνικά::Επίπεδο Α2::Η άδεια διαμονής, το πολιτικό άσυλο / ВНЖ, политическое убежище	запрос на предоставление / на продление срока действия 	η αίτηση για χορήγηση / για ανανέωση
A~.gD	Ελληνικά::Επίπεδο Α2::Η άδεια διαμονής, το πολιτικό άσυλο / ВНЖ, политическое убежище	муниципалитет	ο δήμος
^[LmI	Ελληνικά::Επίπεδο Α2::Η άδεια διαμονής, το πολιτικό άσυλο / ВНЖ, политическое убежище	паспорт	το διαβατήριο 
h0oE7	Ελληνικά::Επίπεδο Α2::Η άδεια διαμονής, το πολιτικό άσυλο / ВНЖ, политическое убежище	цветные / чёрно-белые фотографии	οι έγχρωμες / μαυρόασπρες φωτογραφίες 
L}jzP	Ελληνικά::Επίπεδο Α2::Η άδεια διαμονής, το πολιτικό άσυλο / ВНЖ, политическое убежище	чек из налоговой / налоговая декларация 	το εκκαθαριστικό σημείωμα από την εφορία / η φορολογική δήλωση
O=ilJ	Ελληνικά::Επίπεδο Α2::Η άδεια διαμονής, το πολιτικό άσυλο / ВНЖ, политическое убежище	вступительный взнос, счёт	το παράβολο
|j$YI	Ελληνικά::Επίπεδο Α2::Η άδεια διαμονής, το πολιτικό άσυλο / ВНЖ, политическое убежище	справка о состоянии здоровья 	το πιστοποιητικό υγείας 
2S7}B	Ελληνικά::Επίπεδο Α2::Η άδεια διαμονής, το πολιτικό άσυλο / ВНЖ, политическое убежище	государственная больница	το κρατικό νοσοκομείο 
/tNmS	Ελληνικά::Επίπεδο Α2::Η άδεια διαμονής, το πολιτικό άσυλο / ВНЖ, политическое убежище	страховая компания	ο ασφαλιστικός φορέας
nXXeU	Ελληνικά::Επίπεδο Α2::Η άδεια διαμονής, το πολιτικό άσυλο / ВНЖ, политическое убежище	медкнижка	το βιβλιάριο υγείας 
nDL+S	Ελληνικά::Επίπεδο Α2::Η άδεια διαμονής, το πολιτικό άσυλο / ВНЖ, политическое убежище	запрос	η αίτηση
KE>p8	Ελληνικά::Επίπεδο Α2::Η άδεια διαμονής, το πολιτικό άσυλο / ВНЖ, политическое убежище	интервью 	η συνέντευξη 
//N}S	Ελληνικά::Επίπεδο Α2::Η άδεια διαμονής, το πολιτικό άσυλο / ВНЖ, политическое убежище	Центры Обслуживания Граждан	Τα ΚΕΠ (Κέντρο Εξυπηρέτησης του Πολίτη)
C%IT-vyX@X	Ελληνικά::Ρήματα::Τύπος Γ1	нахожусь	βρίσκομαι, βρέθηκα, θα βρεθώ, βρίσκεσαι, βρέθηκες, θα βρεθείς, βρίσκεται, βρέθηκε, θα βρεθεί, βρισκόμαστε, βρεθήκαме, θα βρεθούμе, βρισκόσαστε, βρεθήκατε, θα βρεθείτε, βρίσκονται, βρέθηκαν, θα βρεθούν
POG1-/AAh%	Ελληνικά::Ρήματα::Τύπος Γ1	становлюсь	γίνομαι, έγινα, θα γίνω
dTaJy%S(O{	Ελληνικά::Ρήματα::Τύπος Γ1	отдыхаю	ξεκουράζομαι, ξεκουράστηκα, θα ξεκουραστώ
"ITJ&QJP;|#"	Ελληνικά::Ρήματα::Τύπος Γ1	устаю	κουράζομαι, κουράστηκα, θα κουραστώ
gaHk:r^ok*	Ελληνικά::Ρήματα::Τύπος Γ1	сижу	κάθομαι, κάθισα, θα καθίσω, κάθομαι, έκατσα, θα κάτσω
I}zng.Y>2n	Ελληνικά::Ρήματα::Τύπος Γ1	чувствую	αισθάνομαι, αισθάνθηκα, θα αισθανθώ
"Q`iSC-#_uD"	Ελληνικά::Ρήματα::Τύπος Γ1	нуждаюсь	χρειάζομαι, χρειάστηκα, θα χρειαστώ
xusF+{s5Xq	Ελληνικά::Ρήματα::Τύπος Γ1	доверяю	εμπιστεύομαι, εμπιστεύτηκα, θα εμπιστευτώ
H7.-ySOEX^	Ελληνικά::Ρήματα::Τύπος Γ1	женюсь, выхожу замуж	παντρεύομαι, παντρεύτηκα, θα παντρευτώ
dpFO~,+SFo	Ελληνικά::Ρήματα::Τύπος Γ1	мечтаю	ονειρεύομαι, ονειρεύτηκα, θα ονειρευτώ
vwLWj$sQ%$	Ελληνικά::Ρήματα::Τύπος Γ1	желаю	εύχομαι, ευχήθηκα, θα ευχηθώ
Lws>0KaSp:	Ελληνικά::Ρήματα::Τύπος Γ1	прихожу, прибываю	έρχομαι, ήρθα, θα έρθω
d[CqKlwa0R	Ελληνικά::Ρήματα::Τύπος Γ1	выгляжу, кажусь	φαίνομαι, φάνηκα, θα φανώ
N+WYVr%/ql	Ελληνικά::Ρήματα::Τύπος Γ1	работаю	εργάζομαι, εργάστηκα, θα εργαστώ
b5Tz6~O{Lw	Ελληνικά::Ρήματα::Τύπος Γ1	влюбляюсь	ερωτεύομαι, ερωτεύτηκα, θα ερωτευτώ
p`]1P9oarf	Ελληνικά::Ρήματα::Τύπος Γ1	думаю	σκέφτομαι, σκέφτηκα, θα σκεφτώ
LU{C:W=(0Q	Ελληνικά::Ρήματα::Τύπος Γ1	стыжусь	ντρέπομαι, ντράπηκα, θα ντραπώ
ti@<nZde&]	Ελληνικά::Ρήματα::Τύπος Γ2	грущу	λυπάμαι, λυπήθηκα, θα λυπηθώ
"q@JqK`3>[#"	Ελληνικά::Ρήματα::Τύπος Γ2	боюсь	φοβάμαι, φοβήθηκα, θα φοβηθώ
M9:,EJLeX4	Ελληνικά::Ρήματα::Τύπος Γ2	помню, вспоминаю	θυμάμαι, θυμήθηκα, θα θυμηθώ
b{MLFn=u&c	Ελληνικά::Ρήματα::Τύπος Γ2	сплю	κοιμάμαι, κοιμήθηκα, θα κοιμηθώ κοιμάσαι, κοιμήθηκες, θα κοιμηθείς κοιμάται, κοιμήθηκε, θα κοιμηθεί κοιμόμαστε, κοιμηθήκαμε, θα κοιμηθούμε κοιμόσαστε, κοιμηθήκατε, θα κοιμηθείτε κοιμούνται, κοιμήθηκαν, θα κοιμηθούν
"Qn(Sy:#^}}"	Ελληνικά::Γράμματα::Γράμμα σε φίλο/φίλη / Письмо другу/подруге	Дорогие / любимые друзья	Αγαπητοί / Αγαπημένοι μου φίλοι
sJ){yFdU!A	Ελληνικά::Γράμματα::Γράμμα σε φίλο/φίλη / Письмо другу/подруге	Дорогая / любимая Анна	Αγαπητή / Αγαπημένη μου Άννα
k7zR9}E*0{	Ελληνικά::Γράμματα::Γράμμα σε φίλο/φίλη / Письмо другу/подруге	Дорогой / любимый Гьоргос	Αγαπητέ / Αγαπημένε μου Γιώργο
"GYHh#}mc7U"	Ελληνικά::Γράμματα::Γράμμα σε φίλο/φίλη / Письмо другу/подруге	Любимая мама	Αγαπημένη μου μητέρα
MsQ(=X`/mf	Ελληνικά::Γράμματα::Γράμμα σε φίλο/φίλη / Письмо другу/подруге	Привет, Гьоргос / Привет, Мария	Γεια σου Γιώργο / Γεια σου Μαρία 
O~2HYCu3^y	Ελληνικά::Γράμματα::Γράμμα σε φίλο/φίλη / Письмо другу/подруге	Как дела? / Всё хорошо? / У меня всё хорошо / У меня дела не очень 	Τι κάνεις; Όλα καλά; Εγώ είμαι πολύ καλά / Εγώ δεν είμαι πολύ καλά 
IZ0WzP$S!C	Ελληνικά::Γράμματα::Γράμμα σε φίλο/φίλη / Письмо другу/подруге	Жду твоего ответа	Περιμένω την απάντηση σου
Jf9ex]*f%d	Ελληνικά::Γράμματα::Γράμμα σε φίλο/φίλη / Письмо другу/подруге	Увидимся / целую / поцелуйчики / с большой любовью	Τα λέμε / Πολλά φιλιά / Φιλάκια / Με πολύ αγάπη
GG;MOt?zMv	Ελληνικά::Γράμματα::Επίσημο γράμμα / Официальное письмо	Уважаемый господин Пападопуло / Уважаемая госпожа Пападопуло	Αξιότιμε κύριε Παπαδοπούλε / Αξιότιμη κυρία Παπαδόπουλου
EPBl_nQ:09	Ελληνικά::Γράμματα::Επίσημο γράμμα / Официальное письмо	Уважаемые господа (м, ж) / Уважаемый господин, уважаемая госпожа	Αξιότιμοι Κύριοι, αξιότιμες Κυρίες / Αξιότιμε Κύριε, αξιότιμη Κυρία
dMp5Zo>R4i	Ελληνικά::Γράμματα::Επίσημο γράμμα / Официальное письмо	Дорогие дамы и господа / господин директор	Αγαπητές Κυρίες και Κύριοι / κύριε Διευθυντή
CWb]&WBP/k	Ελληνικά::Γράμματα::Επίσημο γράμμα / Официальное письмо	Этим письмом я хотел бы пожаловаться на (сообщить о жалобах на)	Με αυτό το γράμμα θα ήθελα να αναφέρω τα παράπονα μου για
p$lQ.]tzLk	Ελληνικά::Γράμματα::Επίσημο γράμμα / Официальное письмо	Я хотел бы спросить вас	Θα ήθελα να σας ρωτήσω, αν
B|]^Ee-Ij;	Ελληνικά::Γράμματα::Επίσημο γράμμα / Официальное письмо	К сожалению, я вынужден заявить, что	Δυστυχώς πρέπει να σας ανακοινώσω , πως
ccX^G;EL^O	Ελληνικά::Γράμματα::Επίσημο γράμμα / Официальное письмо	Я был бы вам очень благодарен, если	Θα σας ήμουν πολύ ευγνώμων, αν
I%P,|/2u`7	Ελληνικά::Γράμματα::Επίσημο γράμμα / Официальное письмо	Прилагаю к этому письму (вместе с этим письмом вы получите)...	Μαζί με το συγκεκριμένο γράμμα θα λάβετε...
Ba!b9ilvH)	Ελληνικά::Γράμματα::Επίσημο γράμμα / Официальное письмо	Для любой соответствующей информации вы можете связаться со мной по телефону... по электронной почте...	Για κάθε σχετική πληροφορία μπορείτε να επικοινωνήσετε μαζί μου στο τηλέφωνο... ή στην ηλεκτρονική διεύθυνση...
hY9F]pm3Ze	Ελληνικά::Γράμματα::Επίσημο γράμμα / Официальное письмо	Жду вашего ответа и заранее благодарю вас за проявленный интерес	Περιμένω την απάντηση και σας ευχαριστώ εκ των προτέρων για το ενδιαφέρον σας
MZsWX+QXYO	Ελληνικά::Γράμματα::Επίσημο γράμμα / Официальное письмо	Благодарю вас за внимание	Σας ευχαριστώ για την προσοχή σας
g$t;Kg/|Cx	Ελληνικά::Γράμματα::Επίσημο γράμμα / Официальное письмо	Искренне ваш / с уважением	Με εκτίμηση
s.d2]S,NMy	Ελληνικά::Γράμματα::Χρήσιμες φράσεις, λέξεις, σύνδεσμοι / Полезные фразы, слова, связки	Считаю, нам следует...	Πιστεύω ότι πρέπει...
Ny;STQkM.h	Ελληνικά::Γράμματα::Χρήσιμες φράσεις, λέξεις, σύνδεσμοι / Полезные фразы, слова, связки	А именно (более конкретно)	Πιο συγκεκριμένα...
wY_t;5qCg:	Ελληνικά::Γράμματα::Χρήσιμες φράσεις, λέξεις, σύνδεσμοι / Полезные фразы, слова, связки	Думаю, что нам следует...	Νομίζω ότι πρέπει ...
"Q|+#IT3Gjz"	Ελληνικά::Γράμματα::Χρήσιμες φράσεις, λέξεις, σύνδεσμοι / Полезные фразы, слова, связки	Предлагаю...	Προτείνω...
"q[U-K#X|TR"	Ελληνικά::Γράμματα::Χρήσιμες φράσεις, λέξεις, σύνδεσμοι / Полезные фразы, слова, связки	После / затем / позже / поздне́е	Μετά / ύστερα / μετέπειτα / αργότερα
jbWH^Bti>D	Ελληνικά::Γράμματα::Χρήσιμες φράσεις, λέξεις, σύνδεσμοι / Полезные фразы, слова, связки	до	Πριν από 
K6:o*z-j8D	Ελληνικά::Γράμματα::Χρήσιμες φράσεις, λέξεις, σύνδεσμοι / Полезные фразы, слова, связки	когда (не в вопросительном предложении)	όταν 
J*Y1,1]2K{	Ελληνικά::Γράμματα::Χρήσιμες φράσεις, λέξεις, σύνδεσμοι / Полезные фразы, слова, связки	впоследствии / в продолжение / вслед за	ακολούθως / στην συνέχεια / κατόπιν
J6w.eFk=SE	Ελληνικά::Γράμματα::Χρήσιμες φράσεις, λέξεις, σύνδεσμοι / Полезные фразы, слова, связки	Между тем	Εν το μεταξύ
uL4SrRV_fr	Ελληνικά::Γράμματα::Χρήσιμες φράσεις, λέξεις, σύνδεσμοι / Полезные фразы, слова, связки	параллельно 	παράλληλα 
il9pO[Pkpk	Ελληνικά::Γράμματα::Χρήσιμες φράσεις, λέξεις, σύνδεσμοι / Полезные фразы, слова, связки	всё ещё / кроме того / кроме того / в дополнение / кроме этого	ακόμα / ακόμη / επιπλέον / επιπρόσθετα / εκτός από αυτό 
mLyfN4p`13	Ελληνικά::Γράμματα::Χρήσιμες φράσεις, λέξεις, σύνδεσμοι / Полезные фразы, слова, связки	хотя / в отличие от / с другой стороны 	αν και / σε αντίθεση / από την άλλη πλευρά 
wnnBWr&2)Y	Ελληνικά::Γράμματα::Χρήσιμες φράσεις, λέξεις, σύνδεσμοι / Полезные фразы, слова, связки	сначала / во-первых / в начале	καταρχάς / πρώτον / αρχικά 
ATMa7ji>SA	Ελληνικά::Γράμματα::Χρήσιμες φράσεις, λέξεις, σύνδεσμοι / Полезные фразы, слова, связки	во-вторых 	δεύτερον
gsO9?%M)Fw	Ελληνικά::Γράμματα::Χρήσιμες φράσεις, λέξεις, σύνδεσμοι / Полезные фразы, слова, связки	в-третьих	τρίτον
m&9lwLR?>R	Ελληνικά::Γράμματα::Χρήσιμες φράσεις, λέξεις, σύνδεσμοι / Полезные фразы, слова, связки	в-четвёртых 	τέταρτον
tc.V+o~~G{	Ελληνικά::Γράμματα::Χρήσιμες φράσεις, λέξεις, σύνδεσμοι / Полезные фразы, слова, связки	потому что	επειδή 
E%k+(d=!rO	Ελληνικά::Γράμματα::Χρήσιμες φράσεις, λέξεις, σύνδεσμοι / Полезные фразы, слова, связки	почему	γιατί 
L@9V4BT[>$	Ελληνικά::Γράμματα::Χρήσιμες φράσεις, λέξεις, σύνδεσμοι / Полезные фразы, слова, связки	поэтому	γι' αυτό
BC8b~-AkgC	Ελληνικά::Γράμματα::Χρήσιμες φράσεις, λέξεις, σύνδεσμοι / Полезные фразы, слова, связки	в результате / следовательно / следовательно 	ως αποτέλεσμα / συνεπώς / επομένως
B;YRNC:D`z	Ελληνικά::Γράμματα::Χρήσιμες φράσεις, λέξεις, σύνδεσμοι / Полезные фразы, слова, связки	разумеется / разумеется / естественно / понятно	βεβαίως / βέβαια / φυσικά / μάλιστα 
H|1Io}q`q3	Ελληνικά::Γράμματα::Χρήσιμες φράσεις, λέξεις, σύνδεσμοι / Полезные фразы, слова, связки	другими словами	δηλαδή
E{7J2~pt=t	Ελληνικά::Γράμματα::Χρήσιμες φράσεις, λέξεις, σύνδεσμοι / Полезные фразы, слова, связки	например	για παράδειγμα 
c+L>I9e{Dj	Ελληνικά::Γράμματα::Χρήσιμες φράσεις, λέξεις, σύνδεσμοι / Полезные фразы, слова, связки	если	αν
5fC$&Y2GF	Ελληνικά::Γράμματα::Χρήσιμες φράσεις, λέξεις, σύνδεσμοι / Полезные фразы, слова, связки	итак	λοιπόν 
t~?!$1&]~A	Ελληνικά::Γράμματα::Χρήσιμες φράσεις, λέξεις, σύνδεσμοι / Полезные фразы, слова, связки	в заключение 	εν κατακλείδι
euREz0YKXi	Ελληνικά::Γράμματα::Χρήσιμες φράσεις, λέξεις, σύνδεσμοι / Полезные фразы, слова, связки	превосходный, исключительный	ο εξαιρετικός
G3Agqo7_.{	Ελληνικά::Γράμματα::Χρήσιμες φράσεις, λέξεις, σύνδεσμοι / Полезные фразы, слова, связки	замечательный	ο υπέροχος
l{P;k}(hbX	Ελληνικά::Γράμματα::Χρήσιμες φράσεις, λέξεις, σύνδεσμοι / Полезные фразы, слова, связки	замечательный 	ο αξιοθαύμαστος
qM65`=e[gd	Ελληνικά::Γράμματα::Χρήσιμες φράσεις, λέξεις, σύνδεσμοι / Полезные фразы, слова, связки	изысканный	ο εξαίρετος
gffO6{~;,}	Ελληνικά::Γράμματα::Χρήσιμες φράσεις, λέξεις, σύνδεσμοι / Полезные фразы, слова, связки	уникальный, уникальная	ο μοναδικός, η μοναδική
"BoK#9+H%tn"	Ελληνικά::Γράμματα::Χρήσιμες φράσεις, λέξεις, σύνδεσμοι / Полезные фразы, слова, связки	как бы ни / как	όπως / πως
vhP>^;q:pP	Ελληνικά::Γράμματα::Χρήσιμες φράσεις, λέξεις, σύνδεσμοι / Полезные фразы, слова, связки	куда бы ни / где	όπου / που
"LsmV$JyV#)"	Ελληνικά::Γράμματα::Χρήσιμες φράσεις, λέξεις, σύνδεσμοι / Полезные фразы, слова, связки	чего бы ни / что	ότι / τι
I%;~cNLp}K	Ελληνικά::Γράμματα::Χρήσιμες φράσεις, λέξεις, σύνδεσμοι / Полезные фразы, слова, связки	что бы то ни было	Ο, τι / οτιδήποτε 
"zp(#04|NEJ"	Ελληνικά::Γράμματα::Χρήσιμες φράσεις, λέξεις, σύνδεσμοι / Полезные фразы, слова, связки	любой / любая / любое	οποίος / οποία / οποίο
mQRjtwMq!/	Ελληνικά::Γράμματα::Χρήσιμες φράσεις, λέξεις, σύνδεσμοι / Полезные фразы, слова, связки	кто, который	ποιός / ποιά / ποιό / που
p-Nd8LsdBu	Ελληνικά::Unsorted	однако, но	όμως
qs2r0w4cde	Ελληνικά::Unsorted	как	σαν
I*,ti``9Z]	Ελληνικά::Unsorted	после	αφού
KwG|o(FL@w	Ελληνικά::Unsorted	выглядит как	μοιάζει όπως
h1)3[{nC~r	Ελληνικά::Unsorted	намереваюсь, планирую	σκοπεύω, σκόπευσα, θα σκοπεύσω
Hz(dw-l~cl	Ελληνικά::Unsorted	в конце	στο τέλος
nfp(_7/EMW	Ελληνικά::Unsorted	незабываемый, незабываемая	ο αξέχαστος, η αξέχαστη
H%v<4FJ>NW	Ελληνικά::Unsorted	гонка	ο αγώνας
L/<:LxU,5m	Ελληνικά::Unsorted	благотворительность	ο φιλανθρωπικός σκοπός
x7A7oba.oT	Ελληνικά::Unsorted	на открытом пространстве	σε ανοιχτό χώρο
C){/=y?b,q	Ελληνικά::Unsorted	собираю	μαζεύω, μάζεψα, θα μαζέψω
F&.{Pf/ML%	Ελληνικά::Unsorted	вёдра (напр. для мусора)	οι κάδοι (απορριμμάτων)
x_]:I}5t{V	Ελληνικά::Unsorted	переработка (отходов)	η ανακύκλωση
FpA/9]&4_$	Ελληνικά::Unsorted	бумага	το χαρτί
fH^=6a1Dh&	Ελληνικά::Unsorted	стекло	το γυαλί
cv=O8IYX..	Ελληνικά::Unsorted	металл	το μέταλλο
"u#eINsqg.;"	Ελληνικά::Unsorted	достаточно	αρκετά
vfT+;ctJsT	Ελληνικά::Unsorted	запах	η μυρωδιά
De{ECA~7?/	Ελληνικά::Unsorted	позже, после	ύστερα
A71NpK{,d=	Ελληνικά::Unsorted	немедленно, в тот же момент	αμέσως
xZe<-Er`<_	Ελληνικά::Unsorted	потом	έπειτα
@@{7xLR_/	Ελληνικά::Unsorted	к счастью	ευτυχώς
MUd,Of0iZ<	Ελληνικά::Unsorted	к несчастью	δυστυχώς
JTG=1>*cA5	Ελληνικά::Unsorted	такой, так	τόσο
L0P}Bf)~@	Ελληνικά::Unsorted	сколько	όσο
M,57WSjNtr	Ελληνικά::Unsorted	правда	η αλήθεια
wGb?:QGX:b	Ελληνικά::Unsorted	вероятно, возможно	ίσως
B.1gHrpYIp	Ελληνικά::Unsorted	ладно	μάλιστα
s~zzchZN&P	Ελληνικά::Unsorted	необходимость, нужда	η ανάγκη
pJ21GTBpw2	Ελληνικά::Unsorted	конкретный, специфический	ο συγκεκριμένος
p$>wFjFR+0	Ελληνικά::Unsorted	лагерь (детский или палаточный)	η κατασκήνωση
pF53Rlc%g}	Ελληνικά::Unsorted	столовая, буфет	το κυλικείο
OJ0NcgD(,_	Ελληνικά::Unsorted	выигрываю	κερδίζω, κέρδισα, θα κερδίσω
FTeq]*Xs`W	Ελληνικά::Unsorted	информация	οι πληροφορίες
CrIlv]JCaZ	Ελληνικά::Unsorted	конкурс, соревнование	ο διαγωνισμός
mzBtW};/4{	Ελληνικά::Unsorted	выбираю (среди альтернатив)	επιλέγω, επέλεξα, θα επιλέξω
"EbY#9Fe6HS"	Ελληνικά::Unsorted	спокойствие, покой	η ηρεμία
"P4FV)jK#1R"	Ελληνικά::Unsorted	скоро	σύντομα
K(?[4>_v8`	Ελληνικά::Unsorted	полоса	η ρίγα
M4eaUm4gH0	Ελληνικά::Unsorted	волнуюсь, переживаю	ταράζομαι, ταράχτηκα, θα ταραχτώ
o(Nm+(xHoD	Ελληνικά::Unsorted	облачность	η συννεφιά
dPREE*FG2d	Ελληνικά::Unsorted	молнии	οι αστραπές
ASY!k8ER6)	Ελληνικά::Unsorted	ветра	οι άνεμοι
MH/gWL~gIG	Ελληνικά::Unsorted	таблетки	τα χάπια
c2=bM3+*&?	Ελληνικά::Unsorted	отсутствую, скучаю	λείπω, έλειψα, θα λείψω
y+$!vd4uo2	Ελληνικά::Unsorted	прячу	κρύβω, έκρυψα, θα κρύψω
"cT/D/F#KCC"	Ελληνικά::Unsorted	предлагаю	προσφέρω, πρόσφερα, θα προσφέρω
jCn[eV9@0S	Ελληνικά::Unsorted	оплата	η πληρωμή
HlJl9oy[(M	Ελληνικά::Unsorted	описываю	περιγράφω, περιέγραψα, θα περιγράψω
"_5LWk!#*o"	Ελληνικά::Unsorted	опаздываю (форм.)	καθυστερώ, καθυστέρησα, θα καθυστερήσω
LOhvH*7I~/	Ελληνικά::Unsorted	передача (по ТВ, например)	η εκπομπή
M|6y=E7w`+	Ελληνικά::Unsorted	журналист	ο δημοσιογράφος
MA%?+Ly_V;	Ελληνικά::Unsorted	предложение	η πρόταση
vie=R,tn68	Ελληνικά::Unsorted	отопление	η θέρμανση
e7GXNEh|N1	Ελληνικά::Unsorted	устройства	οι συσκευές
x9z>tdg0$W	Ελληνικά::Unsorted	следую, слежу	παρακολουθώ, παρακολούθησα, θα παρακολουθήσω
rZ0Zo=Ww_S	Ελληνικά::Unsorted	земля	η γη
hG:M@|%+sK	Ελληνικά::Unsorted	служу	χρησιμεύω, χρησίμευσα, θα χρησιμεύσω
NE6F_L>Ob&	Ελληνικά::Unsorted	произвожу	παράγω, παρήγαγα, θα παράξω / θα παραγάγω
eOSxwv,nEQ	Ελληνικά::Unsorted	уважение	ο σεβασμός
pKKT%3O3iS	Ελληνικά::Unsorted	среда, окружение	το περιβάλλον
G+TEUT1DTe	Ελληνικά::Unsorted	отношение, связь	η σχέση
d$Yk~>A9TJ	Ελληνικά::Unsorted	создаю (с нуля)	δημιουργώ, δημιούργησα, θα δημιουργήσω
"y#zXsg$C#F"	Ελληνικά::Unsorted	забочусь, ухаживаю	φροντίζω, φρόντισα, θα φροντίσω
F/kXD|&q|6	Ελληνικά::Unsorted	способность, возможность	η δυνατότητα
u]7kZ/X{O`	Ελληνικά::Unsorted	каждый	ο καθένας
dYWd^,@w})	Ελληνικά::Unsorted	в целом, в общем	συνολικά
F(veq_H]sn	Ελληνικά::Unsorted	только что	μόλις
mxye@8qz3<	Ελληνικά::Unsorted	праздник, выходной	η αργία
nUr3B)ij^P	Ελληνικά::Unsorted	совет	η συμβουλή
Qsi?g/zLn{	Ελληνικά::Unsorted	действие	η δράση
Q{W0rU|&L|	Ελληνικά::Unsorted	расстояние	η απόσταση
p0oUxMHYLJ	Ελληνικά::Unsorted	остаток	το υπόλοιπο
QPNs^HWGqF	Ελληνικά::Unsorted	обсуждаю	συζητάω, συζήτησα, θα συζητήσω
u1p9zC,8]	Ελληνικά::Unsorted	некоторый, определённый	ο ορισμένος
JI3@ke&P1l	Ελληνικά::Unsorted	случай	η περίπτωση
u|18l]lR$h	Ελληνικά::Unsorted	постоянно	συνεχώς
"d4#/^)$@u;"	Ελληνικά::Unsorted	решаю (принимаю решение)	αποφασίζω, αποφάσισα, θα αποφασίσω
tQZJucs<fu	Ελληνικά::Unsorted	размер	το μέγεθος
zv:PwA8Sz|	Ελληνικά::Unsorted	приглашение	η πρόσκληση
c{$Zp4)%be	Ελληνικά::Unsorted	название (напр. фильма)	ο τίτλος
r+69f`4^tD	Ελληνικά::Unsorted	полезный, полезная	ο χρήσιμος, η χρήσιμη
j*~[/46YQ9	Ελληνικά::Unsorted	будущий	ο μελλοντικός
d-j^EMj%TN	Ελληνικά::Unsorted	решаю (задачу, проблему)	λύνω, έλυσα, θα λύσω
IBPsOR2.=J	Ελληνικά::Unsorted	считаю, полагаю	νομίζω, νόμισα, θα νομίσω
Am6CHW`YHE	Ελληνικά::Unsorted	соглашаюсь	συμφωνώ, συμφώνησα, θα συμφωνήσω
D-D]xc+NCU	Ελληνικά::Unsorted	не соглашаюсь	διαφωνώ, διαφώνησα, θα διαφωνήσω
"inz#w>zd^7"	Ελληνικά::Unsorted	участник, участники	το μέλος, τα μέλη
g4G<U*C@XN	Ελληνικά::Unsorted	шум	η φασαρία, ο θόρυβος
hEs.),[+S+	Ελληνικά::Unsorted	голос	η φωνή
o!hj9=Syl2	Ελληνικά::Unsorted	принимать участие	παίρνω μέρος
o/[+3YoMnE	Ελληνικά::Unsorted	машина скорой помощи	το ασθενοφόρο
HWpHUt`AJ+	Ελληνικά::Γράμματα::Επίσημο γράμμα / Официальное письмо	можете прийти / посмотреть / попробовать	μπορείτε να πάτε / δείτε / δοκιμάσετε
hpYM^ZWWy4	Ελληνικά::Γράμματα::Επίσημο γράμμα / Официальное письмо	приезжайте в мой город, потому что здесь есть уникальная атмосфера	ελάτε στην πόλη μου, γιατί εδω υπάρχει μοναδική ατμόσφαιρα
D+cPKpYdHj	Ελληνικά::Unsorted	предлагаю вам пойти	σας προτείνω να πάτε
p@hiFq9pN)	Ελληνικά::Γράμματα::Γράμμα σε φίλο/φίλη / Письмо другу/подруге	было бы отлично / было бы отличной идеей (предложение)	θα ήταν καλά να / θα ήταν καλή ιδέα
Dq,EO0fU`H	Ελληνικά::Unsorted	рисунок	η ζωγραφιά
ha@mSr%P$]	Ελληνικά::Γράμματα::Γράμμα σε φίλο/φίλη / Письмо другу/подруге	Хочешь поехать вместе со мной?	Θέλεις να έρθεις μαζί μου;
d52uV7mZ/m	Ελληνικά::Unsorted	археологические места	οι αρχαιολογικοί χώροι
cp[5,`wXob	Ελληνικά::Unsorted	художник	ο καλλιτέχνης
dde+[5w;/a	Ελληνικά::Unsorted	вижу себя (например, в зеркало)	βλέπω τον εαυτό μου
b_N$dNrJR|	Ελληνικά::Unsorted	приложение (для телефона, компьютера)	η εφαρμογή
.mJz@{r%.	Ελληνικά::Unsorted	добродушный (добросердечный)	ο καλόκαρδος, η καλόκαρδη
cv4L3S;kSk	Ελληνικά::Unsorted	рано	νωρίς
A9QE,^8QR1	Ελληνικά::Επίπεδο Α2::Διαδίκτυο / Интернет	сайт	η ιστοσελίδα 
"i3WXa](uN#"	Ελληνικά::Επίπεδο Α2::Επιπλέον / Дополнительно	шанс, возможность	η ευκαιρία 
b+>{X(O1@H	Ελληνικά::Επίπεδο Α2::Επιπλέον / Дополнительно	кроме того, дополнительно	επιπλέον 
LEnh|s<i(P	Ελληνικά::Επίπεδο Α2::Επιπλέον / Дополнительно	отмечаю, примечаю	σημειώνω, σημείωσα, θα σημειώσω
o6Sr4Un+m:	Ελληνικά::Επίπεδο Α2::Επιπλέον / Дополнительно	запрос, вопрос, задание	το ερώτημα
v,wASJP}?g	Ελληνικά::Γράμματα::Χρήσιμες φράσεις, λέξεις, σύνδεσμοι / Полезные фразы, слова, связки	Не упустите шанс хорошо провести время	Μη χάσετε την ευκαιρία να περάσετε καλά
I>/pGbBx?r	Ελληνικά::Επίπεδο Α2::Ασθένειες / Болезнь	не могу двигаться	δεν μπορώ να κουνηθώ
K)4Udd$v$w	Ελληνικά::Επίπεδο Α2::Επιπλέον / Дополнительно	уроки, д.з., чтение	το διάβασμα
yKO;^B9<7(	Ελληνικά::Επίπεδο Α2::Επιπλέον / Дополнительно	невероятный, невероятная / невероятно	ο απίστευτος, η απίστευτη / απίστευτα
LTgS;J=VOG	Ελληνικά::Επίπεδο Α2::Επιπλέον / Дополнительно	постоянно	μόνιμα 
y;l_MbWO7f	Ελληνικά::Επίπεδο Α2::Επιπλέον / Дополнительно	успевать, иметь время	προλαβαίνω, πρόλαβα, θα προλάβω
"eT_#rvCZS^"	Ελληνικά::Επίπεδο Α2::Επιπλέον / Дополнительно	деталь, подробность	η λεπτομέρεια 
wW/nO-p`!+	Ελληνικά::Επίπεδο Α2::Επιπλέον / Дополнительно	удивительный, удивительная	ο καταπληκτικός, η καταπληκτική
LjoL&PD{wv	Ελληνικά::Επίπεδο Α2::Επιπλέον / Дополнительно	принадлежу	ανήκω, ανήκα, θα ανήκω
zi2r2{0~hs	Ελληνικά::Επίπεδο Α2::Επιπλέον / Дополнительно	обеспокоена	η στενοχωρημένη
uDZE7yhx$m	Ελληνικά::Επίπεδο Α2::Επιπλέον / Дополнительно	повторяю, говорю ещё раз	ξαναλέω, ξαναείπα, θα ξαναπώ
e|g^Oi(?:`	Ελληνικά::Επίπεδο Α2::Επιπλέον / Дополнительно	но, однако	όμως 
vOW`uO_xh,	Ελληνικά::Επίπεδο Α2::Επιπλέον / Дополнительно	срок, продолжительность, период	η διάρκεια 
qXh*t`q{pD	Ελληνικά::Επίπεδο Α2::Επιπλέον / Дополнительно	занятие	η ασχολία 
PJj:yj9XM/	Ελληνικά::Επίπεδο Α2::Επιπλέον / Дополнительно	одинокий, одинокая	ο μοναχικός, η μοναχική
IdI!EgUq;/	Ελληνικά::Επίπεδο Α2::Επιπλέον / Дополнительно	сокурсники	οι συμφοιτητές
rmS}1h1fur	Ελληνικά::Επίπεδο Α2::Επιπλέον / Дополнительно	одноклассники	οι συμμαθητές
y0ne:.3vEj	Ελληνικά::Επίπεδο Α2::Επιπλέον / Дополнительно	виды, товары	τα είδη 
DPA;$DkBL/	Ελληνικά::Επίπεδο Α2::Επιπλέον / Дополнительно	появление 	η εμφάνιση
B`2LYZ[.2V	Ελληνικά::Επίπεδο Α2::Επιπλέον / Дополнительно	тридцать процентов, 30%	τριάντα τοις εκατό 
P.pFJXh0,}	Ελληνικά::Γράμματα::Χρήσιμες φράσεις, λέξεις, σύνδεσμοι / Полезные фразы, слова, связки	Жду, что вы мне напишете	Περιμένω να μου γράψετε
rbJ;Zt/Xam	Ελληνικά::Επίπεδο Α2::Διαδίκτυο / Интернет	виртуальная реальность	η εικονική πραγματικότητα 
K>G2TqKc2i	Ελληνικά::Επίπεδο Α2::Σπίτι / Дом	камин	το τζάκι 
PTR;RL|8^_	Ελληνικά::Επίπεδο Α2::Σπίτι / Дом	раздельные (санузлы, например)	τα ξεχωριστά 
b*jn1l2keD	Ελληνικά::Επίπεδο Α2::Σπίτι / Дом	арендовать	νοικιάζω, νοίκιασα, θα νοικιάσω
bSr._Fx%?k	Ελληνικά::Επίπεδο Α2::Έξω / На улице	памятник	το μνημείο
tdZqebz~hW	Ελληνικά::Επίπεδο Α2::Έξω / На улице	начальная точка	η αφετηρία
"he8EF}#?wQ"	Ελληνικά::Επίπεδο Α2::Επιπλέον / Дополнительно	выбираю (в общем смысле)	διαλέγω, διάλεξα, θα διαλέξω
"cKV4q).)g#"	Ελληνικά::Επίπεδο Α2::Επιπλέον / Дополнительно	шатенка	η καστανή
MfPt:1-n{{	Ελληνικά::Επίπεδο Α2::Επιπλέον / Дополнительно	младшая, старшая (дочь)	η μικρή, η μεγάλη
FTph>sko7C	Ελληνικά::Επίπεδο Α2::Επιπλέον / Дополнительно	Я давно её не видела	Είχα πολύ καιρό να τη δω
C`>|1[>v^F	Ελληνικά::Επίπεδο Α2::Επιπλέον / Дополнительно	развожусь, расстаюсь	χωρίζω, χώρισα, θα χωρίσω
IfGS6SGT:s	Ελληνικά::Unsorted	личный, частный	ο ιδιωτικός, η ιδιωτική
C-?0Nrf+U	Ελληνικά::Unsorted	мозг	ο εγκέφαλος
i%:R?pD326	Ελληνικά::Unsorted	недавний, недавняя / недавно	ο πρόσφατος, η πρόσφατη / πρόσφατα
m%PHzt{dxL	Ελληνικά::Unsorted	постоянно	μόνιμα
ACm?|EV:p>	Ελληνικά::Unsorted	пульт (например, от телевизора)	το τηλεχειριστήριο
"iez2P=Q#lG"	Ελληνικά::Unsorted	ежедневно	καθημερινά
"uoae<)#h&%"	Ελληνικά::Unsorted	называюсь	ονομάζομαι, ονομάστηκα, θα ονομαστώ
E_:k8L/u+Q	Ελληνικά::Unsorted	возвращаюсь	επιστρέφω, επέστρεψα, θά επιστρέψω
to0J^mtjs4	Ελληνικά::Γράμματα::Γράμμα σε φίλο/φίλη / Письмо другу/подруге	Гьорго понравились...	Στον Γιώργο άρεσαν οι
IbVb0?%rh,	Ελληνικά::Unsorted	свежий, свежая	ο φρέσκος, η φρέσκια
+<6<gMHJO	Ελληνικά::Unsorted	вход	η είσοδος
x=*7UbrpcM	Ελληνικά::Unsorted	выход	η έξοδος
oDeOr0-DuN	Ελληνικά::Επίπεδο Β1::Επιπλέον / Дополнительно	садоводство	η κηπουρική
BJ`MTUuN6M	Ελληνικά::Επίπεδο Β1::Επιπλέον / Дополнительно	привычка	η συνήθεια
uja&jeu))w	Ελληνικά::Επίπεδο Β1::Επιπλέον / Дополнительно	общение	η επαφή
"y1VZ#2/9]~"	Ελληνικά::Επίπεδο Β1::Τα ρήματα / Глаголы	питаюсь	τρέφομαι, τράφηκα, θα τραφώ
D$rM!i0iZU	Ελληνικά::Επίπεδο Β1::Επιπλέον / Дополнительно	способный	ο ικανός
gbQC`mUSnp	Ελληνικά::Επίπεδο Β1::Τα ρήματα / Глаголы	работаю (напр. про часы работы магазина)	λειτουργώ, λειτούργησα, θά λειτουργήσω
zURB/<jAF|	Ελληνικά::Επίπεδο Β1::Επιπλέον / Дополнительно	коллекция (например, картин)	η συλλογή 
piNr$E:Y>9	Ελληνικά::Επίπεδο Β1::Επιπλέον / Дополнительно	открытие (например, нового магазина)	τα εγκαίνια
n5P9Ob`gM_	Ελληνικά::Επίπεδο Β1::Επιπλέον / Дополнительно	знаменитое	το διάσημο
z+c)!l)@vh	Ελληνικά::Επίπεδο Β1::Τα ρήματα / Глаголы	считаюсь	θεωρούμαι, θεωρήθηκα, θα θεωρηθώ
BIyVnrSf0(	Ελληνικά::Επίπεδο Β1::Επιπλέον / Дополнительно	в основном	κυρίως
IpgOQVW,S;	Ελληνικά::Επίπεδο Β1::Τα ρήματα / Глаголы	входить, быть в составе, связывать	συνδέομαι, συνδέθηκα, θα συνδεθώ
"n=z#b2Xud."	Ελληνικά::Επίπεδο Β1::Επιπλέον / Дополнительно	всемирно известное	το παγκοσμίως γνωστό
"wv[{qo#-:8"	Ελληνικά::Επίπεδο Β1::Επιπλέον / Дополнительно	ориентирован на детский возраст с 6 до 12 лет	απευθύνεται σε παιδιά ηλικίας έξι έως δώδεκα ετών
lIN]@CeFdP	Ελληνικά::Επίπεδο Β1::Επιπλέον / Дополнительно	чувство 	το συναίσθημα
f@(rs]^:s-	Ελληνικά::Επίπεδο Β1::Επιπλέον / Дополнительно	цель	ο σκοπός
rQ^E8g<5,a	Ελληνικά::Επίπεδο Β1::Επιπλέον / Дополнительно	образовательное	το εκπαιδευτικό 
ssCVH$YG<{	Ελληνικά::Επίπεδο Β1::Επιπλέον / Дополнительно	сказка, сказки	το παραμύθι, τα παραμύθια
d*0}V4o.TJ	Ελληνικά::Επίπεδο Β1::Επιπλέον / Дополнительно	эксперименты	τα πειράματα 
"J6#O:R`h~Z"	Ελληνικά::Επίπεδο Β1::Επιπλέον / Дополнительно	подросток	ο/η έφηβος
Lj}v0.3~zP	Ελληνικά::Επίπεδο Β1::Επιπλέον / Дополнительно	участие	η συμμετοχή
q=4D51)nQH	Ελληνικά::Επίπεδο Β1::Τα ρήματα / Глаголы	полагаюсь	στηρίζομαι, στηρίχτηκα, θα στηριχτώ
nt@+w9,_`e	Ελληνικά::Επίπεδο Β1::Επιπλέον / Дополнительно	билеты со скидкой	τα μειωμένα εισιτήρια
F8n189}w+	Ελληνικά::Επίπεδο Β1::Επιπλέον / Дополнительно	ссорились из-за столика / дрались за столик (в кафе)	μάλωναν για ένα τραπέζι 
uBWz4+s<0i	Ελληνικά::Επίπεδο Β1::Τα ρήματα / Глаголы	успевать / догонять	προφταίνω, πρόφτασα, θα προφτάσω
tnXXFr(2Q]	Ελληνικά::Επίπεδο Β1::Τα ρήματα / Глаголы	печь, выпекать	ψήνω, έψησα, θα ψήσω
z`>vT5j+Qe	Ελληνικά::Επίπεδο Β1::Επιπλέον / Дополнительно	бараньи отбивные	τα παϊδάκια
Hw(Uy4C7mn	Ελληνικά::Επίπεδο Β1::Επιπλέον / Дополнительно	нагруженный (например, едой)	ο φορτωμένος
q{6ga|C%9t	Ελληνικά::Επίπεδο Β1::Επιπλέον / Дополнительно	деревенские жители	οι χωριανοί
p6*JZck1mB	Ελληνικά::Επίπεδο Β1::Επιπλέον / Дополнительно	разговор, беседа	η κουβέντα 
b<}R1_ot]B	Ελληνικά::Επίπεδο Β1::Επιπλέον / Дополнительно	впечатлённый	ο εντυπωσιασμένος
L`Kf_uH*9;	Ελληνικά::Επίπεδο Β1::Επιπλέον / Дополнительно	богатства	τα πλούτη
dWH:]qHVJw	Ελληνικά::Επίπεδο Β1::Επιπλέον / Дополнительно	впечатление	η εντύπωση
xyU|hj<dRo	Ελληνικά::Επίπεδο Β1::Τα ρήματα / Глаголы	выразить	εκφράζω, εξέφρασα, θα εκφράσω
k<:=b@Yw8v	Ελληνικά::Επίπεδο Β1::Τα ρήματα / Глаголы	соответствовать	ταιριάζω, ταίριαξα, θα ταιριάξω
ifrmN0(Y<}	Ελληνικά::Επίπεδο Β1::Επιπλέον / Дополнительно	пробел / пробелы	το κενό / τα κενά
h~?w>4)Vz?	Ελληνικά::Επίπεδο Β1::Επιπλέον / Дополнительно	причина	η αιτία 
P)L!CUa9_/	Ελληνικά::Επίπεδο Β1::Επιπλέον / Дополнительно	расходы / уменьшать расходы	τα έξοδα / μειώνω τα έξοδα
vsuLk&-H`w	Ελληνικά::Επίπεδο Β1::Επιπλέον / Дополнительно	вид отопления	το είδος της θέρμανσης
FiD@sgXbYh	Ελληνικά::Επίπεδο Β1::Επιπλέον / Дополнительно	другие арендаторы	οι υπόλοιποι ενοικιαστές
AQ)~3z42!6	Ελληνικά::Επίπεδο Β1::Επιπλέον / Дополнительно	иначе	διαφορετικά 
mI{uH6?E}y	Ελληνικά::Επίπεδο Β1::Επιπλέον / Дополнительно	страдать	υποφέρω, υπέφερα, θα υποφέρω
"HWP1A#EyD-"	Ελληνικά::Επίπεδο Β1::Επιπλέον / Дополнительно	проверяю	ελέγχω, έλεγξα, θα ελέγξω
IO0(7O4%wC	Ελληνικά::Επίπεδο Β1::Η συζήτηση, εκφράσεις / Беседа, фразы	возможно	μάλλον 
"N#^_r@>srq"	Ελληνικά::Επίπεδο Β1::Επιπλέον / Дополнительно	суета, шум	η φασαρία
F9U!&<fEsZ	Ελληνικά::Επίπεδο Β1::Επιπλέον / Дополнительно	потребность / ежедневные потребности	η ανάγκη / οι καθημερινές ανάγκες 
lt&@+/u}4&	Ελληνικά::Επίπεδο Α2::Το θέατρο / Театр	дым (в т.ч. на сцене)	ο καπνός
q85ig$3E%L	Ελληνικά::Επίπεδο Α2::Το θέατρο / Театр	накидка	ο χιτώνας, το ακρωτήριο
tH.al|Gp6;	Ελληνικά::Επίπεδο Α2::Η μουσική / Музыка	много народа (есть)	υπάρχει πολύς κόσμος 
v_=}@;(-j~	Ελληνικά::Επίπεδο Α2::Η μουσική / Музыка	музыкальная группа	το συγκρότημα
"I&R^+lis#}"	Ελληνικά::Επίπεδο Α2::Οι γιορτές / Праздники	время Рождества	η εποχή των Χριστουγέννων 
s)a}.geYSi	Ελληνικά::Επίπεδο Α2::Επιπλέον / Дополнительно	девять из них	εννιά από αυτούς
t]ylq(uY/)	Ελληνικά::Επίπεδο Α2::Επιπλέον / Дополнительно	раньше	παλιά 
j6Rb@)MCXf	Ελληνικά::Επίπεδο Α2::Επιπλέον / Дополнительно	местные люди / местное вино	οι ντόπιοι / το τοπικό κρασί 
B`d*T4]PI(	Ελληνικά::Επίπεδο Α2::Επιπλέον / Дополнительно	флаг	η σημαία 
iyS|(o_l&w	Ελληνικά::Επίπεδο Α2::Επιπλέον / Дополнительно	перенести дату (например, приёма)	μεταφέρω ημερομηνία 
L~N*Z%l[,=	Ελληνικά::Επίπεδο Α2::Επιπλέον / Дополнительно	гостиница для собак	το ξενοδοχείο σκύλων
o9=mj?iqGR	Ελληνικά::Επίπεδο Α2::Επιπλέον / Дополнительно	чем могу вам помочь	πως μπορώ να σας βοηθήσω
K(b%gFmZ23	Ελληνικά::Επίπεδο Α2::Επιπλέον / Дополнительно	кормлю	ταΐζω, τάισα, θα ταΐσω
AxCDu.V9}A	Ελληνικά::Επίπεδο Α2::Επιπλέον / Дополнительно	корм (для животных)	η τροφή
DUV@rz@~j<	Ελληνικά::Επίπεδο Α2::Επιπλέον / Дополнительно	палатка	η σκηνή
hx3<8|7/B~	Ελληνικά::Επίπεδο Α2::Επιπλέον / Дополнительно	соболезнования 	τα συλληπητήρια 
Obj~:z@q0m	Ελληνικά::Επίπεδο Α2::Επιπλέον / Дополнительно	будем очень рады, если вы будете рядом с нами	θα χαρούμε να σας έχουμε κοντά μας
d|)X63~$9e	Ελληνικά::Επίπεδο Α2::Επιπλέον / Дополнительно	приближаться	πλησιάζω, πλησίασα, θα πλησιάσω
PikBBZqM{,	Ελληνικά::Επίπεδο Β1::Επιπλέον / Дополнительно	насилие	η βία 
DfB[Tl%Ep~	Ελληνικά::Επίπεδο Α2::Συζήτηση / Беседа	не могли бы вы повторить это, пожалуйста	μπορείτε να το πείτε ξανά, παρακαλώ 
ODqL+WwD5?	Ελληνικά::Επίπεδο Α2::Συζήτηση / Беседа	повторите, пожалуйста	ξαναπείτε / επαναλάβετε παρακαλω
J[G~VTvc;!	Ελληνικά::Επίπεδο Α2::Επιπλέον / Дополнительно	экстремист	ο εξτρεμιστής
li0V-[5~7r	Ελληνικά::Επίπεδο Α2::Επιπλέον / Дополнительно	тем не менее (всё-таки, несмотря на всё это)	παρά όλα αυτά (παρ' όλ' αυτά)
iN`o5c2O%K	Ελληνικά::Επίπεδο Α2::Επιπλέον / Дополнительно	групповой урок / индивидуальный урок	το φροντιστήριο / το ιδιωτικό μάθημα
nD=ogi1N[b	Ελληνικά::Επίπεδο Α2::Επιπλέον / Дополнительно	ум	το μυαλό 
yS[Ke>6EcH	Ελληνικά::Επίπεδο Α2::Επιπλέον / Дополнительно	черновик	το πρόχειρο 
p^b}GP.]7)	Ελληνικά::Επίπεδο Α2::Επιπλέον / Дополнительно	наблюдение, замечание	η παρατήρηση
"kyLRQ6ws#U"	Ελληνικά::Επίπεδο Α2::Επιπλέον / Дополнительно	практика	η εξάσκηση 
D.5i>Z}m+@	Ελληνικά::Επίπεδο Α2::Σπίτι / Дом	лифт	ο ανελκυστήρας, το ασανσέρ
oU.x>2~=sG	Ελληνικά::Επίπεδο Α2::Σπίτι / Дом	устойчивое здание	το γερό κτήριο
JR8A%j%p70	Ελληνικά::Επίπεδο Α2::Συζήτηση / Беседа	что это значит?	τι σημαίνει;
v375mjv[}3	Ελληνικά::Επίπεδο Α2::Συζήτηση / Беседа	не переживай / всё нормально / не бери в голову	δεν πειράζει 
gX5hJ<a}TF	Ελληνικά::Επίπεδο Α2::Συζήτηση / Беседа	удачи	καλή επιτυχία 
t>K;XATmcO	Ελληνικά::Επίπεδο Α2::Το θέατρο / Театр	сцена	η σκηνή 
HEhJSHrt.4	Ελληνικά::Επίπεδο Α2::Το θέατρο / Театр	труппа	ο θίασος
f}8a@b*_+?	Ελληνικά::Επίπεδο Α2::Το θέατρο / Театр	одеяние	το ντύσιμο
s`W%V4{8CF	Ελληνικά::Επίπεδο Α2::Το θέατρο / Театр	герой	ο ήρωας
N;cF8h?g=;	Ελληνικά::Επίπεδο Α2::Το θέατρο / Театр	история	η ιστορία 
c*[VembbUD	Ελληνικά::Επίπεδο Α2::Το θέατρο / Театр	постановка, спектакль	η παράσταση 
qM3`0BAA)?	Ελληνικά::Επίπεδο Α2::Το θέατρο / Театр	режиссер	ο σκηνοθέτης
MrEg03I=@x	Ελληνικά::Επίπεδο Α2::Το θέατρο / Театр	главный герой	ο πρωταγωνιστής 
k$}%6h:EW{	Ελληνικά::Επίπεδο Α2::Οι γιορτές / Праздники	праздник	η γιορτή 
gH)~PM6!lG	Ελληνικά::Επίπεδο Α2::Οι γιορτές / Праздники	поздравляю	συγχαίρω, συγχάρηκα, θα συγχαρώ
sK;-eXI]}F	Ελληνικά::Επίπεδο Α2::Οι γιορτές / Праздники	дарить подарок 	κάνω δώρο
tOV71n6XH+	Ελληνικά::Επίπεδο Α2::Οι γιορτές / Праздники	дарить	χαρίζω, χάρισα, θα χαρίσω
oz95Ol~mxV	Ελληνικά::Επίπεδο Α2::Οι γιορτές / Праздники	обниматься	αγκαλιάζω, αγκάλιασα, θα αγκαλιάσω
OT!O|cb}~]	Ελληνικά::Επίπεδο Α2::Οι γιορτές / Праздники	сердце	η καρδιά
IYg.?i@+*k	Ελληνικά::Επίπεδο Α2::Οι γιορτές / Праздники	компания (друзей)	παρέα 
M-?GQ/pjfx	Ελληνικά::Επίπεδο Α2::Η μουσική / Музыка	рок	το ροκ
pDn57LtT(;	Ελληνικά::Επίπεδο Α2::Η μουσική / Музыка	слушатель, слушатели	ο ακροατής, οι ακροατές
A$L0Xk*-7:	Ελληνικά::Επίπεδο Α2::Η μουσική / Музыка	фанат, поклонник	ο/η οπαδός 
yNXebIZ0;Y	Ελληνικά::Επίπεδο Α2::Το άθλημα (το σπορ) / Спорт	лес	το δάσος 
l|A&o&vSNF	Ελληνικά::Επίπεδο Α2::Το άθλημα (το σπορ) / Спорт	озеро	η λίμνη
lXQWm.cYB6	Ελληνικά::Επίπεδο Α2::Το άθλημα (το σπορ) / Спорт	дикая природа 	η άγρια φύση
d+b!$q,SJ{	Ελληνικά::Επίπεδο Α2::Το άθλημα (το σπορ) / Спорт	ставить палатку	κάνω σκηνή 
D58q/c+*w_	Ελληνικά::Επίπεδο Α2::Το άθλημα (το σπορ) / Спорт	наслаждаюсь	απολαμβάνω, απόλαυσα, θα απολαύσω
"MMMf^)#{6x"	Ελληνικά::Επίπεδο Α2::Το άθλημα (το σπορ) / Спорт	рюкзак	το σακίδιο
uT7FU[4aR/	Ελληνικά::Επίπεδο Α2::Οι γιορτές / Праздники	проводить время вместе	περνάω χρόνο μαζί 
TomUw3kr>	Ελληνικά::Επίπεδο Α2::Ασθένειες / Болезнь	встреча / встретиться	η συνάντηση / συναντάω, συνάντησα, θα συναντήσω
AHzaxj?_VO	Ελληνικά::Επίπεδο Α2::Ασθένειες / Болезнь	срочно	επείγον
G<qD==(K<(	Ελληνικά::Επίπεδο Α2::Ασθένειες / Болезнь	кабинет врача	το ιατρείο
IK}rLxXkW	Ελληνικά::Επίπεδο Α2::Ασθένειες / Болезнь	принимает врач / принимаю	δέχεται ο γιατρός / δέχομαι
Fg/BeGU[y;	Ελληνικά::Επίπεδο Α2::Μαγειρική / Кулинария	растительное масло	το λάδι 
jD<?ri[5<Q	Ελληνικά::Επίπεδο Α2::Μαγειρική / Кулинария	кастрюля	η κατσαρόλα 
uLSN61P1N+	Ελληνικά::Επίπεδο Α2::Μαγειρική / Кулинария	соус	η σάλτσα 
fo-beC:`!V	Ελληνικά::Επίπεδο Α2::Μαγειρική / Кулинария	перец (приправа)	το πιπέρι 
K1p<w;so]5	Ελληνικά::Επίπεδο Α2::Μαγειρική / Кулинария	приятного аппетита 	καλή όρεξη 
fbJngu332a	Ελληνικά::Επίπεδο Α2::Μαγειρική / Кулинария	плита	η κουζίνα 
v*u(ZFXr{|	Ελληνικά::Επίπεδο Α2::Μαγειρική / Кулинария	сито	το τρυπητό
g%!_T?ZS~7	Ελληνικά::Επίπεδο Α2::Μαγειρική / Кулинария	дуршлаг	το σουρωτήρι
Q!fYFwu;{M	Ελληνικά::Επίπεδο Α2::Μαγειρική / Кулинария	ингредиент / ингредиенты 	το συστατικό / τα συστατικά 
c:}VxtRS4a	Ελληνικά::Επίπεδο Α2::Μαγειρική / Кулинария	рецепт	η συνταγή 
Fu3p:TplnI	Ελληνικά::Επίπεδο Α2::Μαγειρική / Кулинария	варить / вари	βράζω, έβρασα, θα βράσω / βράζε
e@XksrA-B-	Ελληνικά::Επίπεδο Α2::Μαγειρική / Кулинария	мешаю / перемешай	ανακατεύω, ανακάτεψα, θα ανακατέψω / ανακάτεψε
wp(Tn5e&2>	Ελληνικά::Επίπεδο Α2::Μαγειρική / Кулинария	добавляю / добавь	προσθέτω, προσέθεσα, θα προσθέσω / πρόσθεσε
zL$Z(N{Vr?	Ελληνικά::Επίπεδο Α2::Μαγειρική / Кулинария	бросать / брось	ρίχνω, έριξα, θα ρίξω / ρίξε
B[^?%{,;G`	Ελληνικά::Επίπεδο Α2::Μαγειρική / Кулинария	резать / нарежь небольшими (большими) кусками	κόβω, έκοψα, θα κόψω / κόψε σε μικρά (μεγάλα) κομμάτια
dV]onstPN7	Ελληνικά::Επίπεδο Α2::Μαγειρική / Кулинария	сервировать / сервируй	σερβίρω, σέρβιρα, θα σερβίρω / σερβίρε
gQO9,ikUC0	Ελληνικά::Επίπεδο Α2::Μαγειρική / Кулинария	процеживаю	σουρώνω, σούρωσα, θα σουρώσω
u{`FmFC[s-	Ελληνικά::Επίπεδο Α2::Μαγειρική / Кулинария	тереть / натри сыр	τρίβω, έτριψα, θα τρίψω / τρίψε το τυρί
BI9h&<ScMP	Ελληνικά::Επίπεδο Α2::Μαγειρική / Кулинария	Сколько времени мне нужно варить макароны?	Πόσο καιρό πρέπει να βράσω τα μακαρόνια;
"j?$f#ZTxfI"	Ελληνικά::Επίπεδο Α2::Η αστυνομία / Полиция	полицейский участок	το αστυνομικό τμήμα
Iu<}BSFcao	Ελληνικά::Επίπεδο Α2::Η αστυνομία / Полиция	ключ	το κλειδί 
u:_8Jb~L]7	Ελληνικά::Επίπεδο Α2::Η αστυνομία / Полиция	данные	τα στοιχεία 
IrAc6w*S[!	Ελληνικά::Επίπεδο Α2::Η αστυνομία / Полиция	проигрываю, теряю	χάνω, έχασα, θα χάσω
"kc&#t)SI4+"	Ελληνικά::Επίπεδο Α2::Ψώνια / Шоппинг	торговый центр 	το εμπορικό κέντρο 
oJ@<q!@}~0	Ελληνικά::Επίπεδο Α2::Ψώνια / Шоппинг	магазин	το κατάστημα 
vi+Rt;lPta	Ελληνικά::Επίπεδο Α2::Ψώνια / Шоппинг	интернет	το διαδίκτυο 
MwAR}eG{Xz	Ελληνικά::Επίπεδο Α2::Ψώνια / Шоппинг	скидка	η έκπτωση
"F#TM+KCniC"	Ελληνικά::Επίπεδο Α2::Ψώνια / Шоппинг	выгодное предложение	η προσφορά 
FNpjym`f7&	Ελληνικά::Επίπεδο Α2::Ψώνια / Шоппинг	тратить деньги	ξοδεύω, ξόδεψα, θα ξοδέψω
"QReh?R#ALi"	Ελληνικά::Επίπεδο Α2::Ψώνια / Шоппинг	качество	η ποιότητα 
tSz|[b=uT7	Ελληνικά::Επίπεδο Α2::Ψώνια / Шоппинг	количество 	η ποσότητα
V/+vOh7%[	Ελληνικά::Επίπεδο Α2::Ψώνια / Шоппинг	быстрая доставка	η γρήγορη αποστολή
A$UNXZ~wpk	Ελληνικά::Επίπεδο Α2::Ψώνια / Шоппинг	телеканал	το τηλεοπτικό κανάλι
sC8VjSNO6|	Ελληνικά::Επίπεδο Α2::Ψώνια / Шоппинг	репортёр с ТВ	ο δημοσιογράφος από την τηλεόραση 
tKUa.OFu1`	Ελληνικά::Επίπεδο Α2::Το ταχυδρομείο / Почта	доставка	η αποστολή 
LzW-VstQ,8	Ελληνικά::Επίπεδο Α2::Το ταχυδρομείο / Почта	посылка	το δέμα / το πακέτο
yG4T?78t(Z	Ελληνικά::Επίπεδο Α2::Το ταχυδρομείο / Почта	вес / взвешивать	το βάρος / ζυγίζω, ζύγισα, θα ζυγίσω
"uyxMem#^xt"	Ελληνικά::Επίπεδο Α2::Το ταχυδρομείο / Почта	Какой вес у вашей посылки?	Τι βάρος έχει το πακέτο σας;
Dw$jJ;LobL	Ελληνικά::Επίπεδο Α2::Το ταχυδρομείο / Почта	Я должен взвесить вашу посылку	Πρέπει να ζυγίσω το πακέτο σας
bDo+PU6(Uq	Ελληνικά::Επίπεδο Α2::Το ταχυδρομείο / Почта	Сколько мне понадобится марок?	Πόσα γραμματόσημα χρειάζομαι;
"y)_J#P0F>:"	Ελληνικά::Επίπεδο Α2::Συζήτηση / Беседа	повторите, пожалуйста 	επαναλάβετε παρακαλώ 
"IP&hd1G#cd"	Ελληνικά::Εξετάσεις - культура и история::Культура	Στις 28 … γιορτάζουμε το ΟΧΙ που οι Έλληνες είπαν στους Ιταλούς. 28 … мы празднуем ответ «Нет», данный греками итальянцам	28 Οκτωβρίου
F8yK<DwS<h	Ελληνικά::Εξετάσεις - культура и история::Культура	Πότε η Κύπρος απέκτησε την ανεξαρτησία της; Когда Кипр добился независимости?	Το 1960
N=c}-m6R-x	Ελληνικά::Εξετάσεις - культура и история::Культура	Τι γιορτάζουν στις 25 Μαρτίου στην Κύπρο; Что на Кипре отмечают 25 марта?	Ημέρα της Ελληνικής επανάστασης του 1821 День начала Греческого восстания 1821 года
y4XFPrFqV>	Ελληνικά::Εξετάσεις - культура и история::Культура	Πότε διεξήχθησαν οι πρώτες εκλογές του Προέδρου της Δημοκρατίας; Когда проводились первые выборы президента Кипра?	Το Δεκέμβριο του 1959
sx?y~H0{|/	Ελληνικά::Εξετάσεις - культура и история::Культура	Γράψτε την ημερομηνία του πραξικοπήματος στην Κύπρο το 1974. Назовите дату государственного переворота на Кипре в 1974 году.	15 Ιουλίου
x4Teek(/pV	Ελληνικά::Εξετάσεις - культура и история::Культура	Ποια χώρα εμπλεκόταν στο πραξικόπημα του 1974 στην Κύπρο; Какая страна была вовлечена в переворот 1974 года на Кипре?	Η Ελλάδα
As&8;EoOd(	Ελληνικά::Εξετάσεις - культура и история::Культура	Ποια ήταν η κύρια αιτία που οδήγησε στο πραξικόπημα του 1974 στην Κύπρο; Какова главная причина, приведшая к перевороту 1974 года на Кипре?	Διακοινοτικές ταραχές μεταξύ των Ελληνοκύπριων και Τουρκοκύπριων Межобщинные столкновения между греко-киприотами и турко-киприотами
guJ2Wz2p(2	Ελληνικά::Εξετάσεις - культура и история::Культура	Πότε εγκρίθηκε το Σύνταγμα της Κυπριακής Δημοκρατίας; Когда была утверждена Конституция Республики Кипр?	16 Αυγούστου του 1960
PKkK66Q?|C	Ελληνικά::Εξετάσεις - культура и история::Культура	Ποιο είναι το πλήρες του ακρωνύμιου ΕΟΚΑ; Как расшифровывается аббревиатура ЭОКА?	Εθνική Οργάνωσις Κυπρίων Αγωνιστών Национальная организация кипрских борцов
O-WwFU[X1J	Ελληνικά::Εξετάσεις - культура и история::Культура	Πότε ιδρύθηκε η ΕΟΚΑ; Когда была основана ЭОКА?	Το 1955
M)LIZieB:M	Ελληνικά::Εξετάσεις - культура и история::Культура	Πότε ολοκληρώθηκε ο αγώνας της ΕΟΚΑ; Когда завершилась борьба ЭОКА?	Το 1959
A4+hy9_MHs	Ελληνικά::Εξετάσεις - культура и история::Культура	Σύμφωνα με τη ᾽Θεογονία᾽ του αρχαίου ποιητή Ησίοδου η θεά Αφροδίτη γεννήθηκε… Согласно «Теогонии» античного поэта Гесиода богиня Афродита родилась...	από τον αφρό της θάλασσας из морской пены
x]Y3}Sfhvb	Ελληνικά::Εξετάσεις - культура и история::Культура	Ποιος είναι ο δημιουργός του ποιήματος Ύμνος εις την Ελευθερίαν, το απόσπασμα του οποίου αποτελεί τον εθνικό ύμνο της Ελλάδας και της Κύπρου; Кто автор поэмы «Гимн свободе», отрывок из которой стал государственным гимном Греции и Кипра?	Διονύσιος Σολωμός
qk!tQ2k,,S	Ελληνικά::Εξετάσεις - культура и история::Культура	Ποιος συνθέτης μελοποίησε τον Ύμνον εις την Ελευθερίαν που αποτελεί τον εθνικό ύμνο της Ελλάδας και της Κύπρου; Какой композитор положил на музыку поэму «Гимн свободе», которая стала национальным гимном Греции и Кипра?	Νικόλαος Μάντζαρος
G{CO9}6icU	Ελληνικά::Εξετάσεις - культура и история::Культура	Πώς λεγόταν ο επόμενος Πρόεδρος της Δημοκρατίας μετά τον κύριο Δημήτρη Χριστόφια; Как звали следующего президента после Димитриса Христофиаса?	Νίκος Αναστασιάδης
e1{X(LcP[5	Ελληνικά::Εξετάσεις - культура и история::Культура	Πότε εγκρίθηκε η σημαία της Κύπρου; Когда был утвержден флаг Кипра?	Το 1960
HovCv_V.1X	Ελληνικά::Εξετάσεις - культура и история::Культура	Το 2017 η πολιτιστική πρωτεύουσα της Ευρώπης ήταν… В 2017 году культурной столицей Европы был…	Πάφος
DERi3zdr01	Ελληνικά::Εξετάσεις - культура и история::Культура	Η εκκλησία του αγίου Λαζάρου χτίστηκε πριν… Церковь святого Лазаря была построена...	1100 лет назад (церковь начала строиться в конце IX века)
qrWcRuF|2A	Ελληνικά::Εξετάσεις - культура и история::Культура	Η πόλη φάντασμα στην Κύπρο είναι … «Город-призраком» на Кипре – это…	Βαρώσι ή Βαρώσια
n-|w|h.-bb	Ελληνικά::Εξετάσεις - культура и история::Культура	Αποτελούν την πλειοψηφία του πληθυσμού Составляют большинство населения	Ελληνοκύπριοι
"pgZB+$#4Q{"	Ελληνικά::Εξετάσεις - культура и история::Культура	Ήρθαν στην Κύπρο από το Λίβανο Прибыли на Кипр из Ливана	Μαρωνίτες
"lB,YG/Q#dd"	Ελληνικά::Εξετάσεις - культура и история::Культура	О αριθμός τους μειώνεται συνεχώς Их численность постоянно сокращается	Τουρκοκύπριοι
J0EkEl@3Z!	Ελληνικά::Εξετάσεις - культура и история::Культура	Ήρθαν στην Κύπρο πριν από τη γέννηση του Χριστού Они прибыли на Кипр еще до начала нашей эры	Ελληνοκύπριοι
"v7XY]#rVCl"	Ελληνικά::Εξετάσεις - культура и история::Культура	Κατοικούν όλοι στις πόλεις Живут только в городах	Αρμένιοι
CGUz:WWvcX	Ελληνικά::Εξετάσεις - культура и история::Культура	Ήρθαν στην Κύπρο πριν από 400 περίπου χρόνια Прибыли на Кипр примерно 400 лет назад	Τουρκοκύπριοι
b/O?}lrd}e	Ελληνικά::Εξετάσεις - культура и история::Культура	Κατοικούν όλοι σχεδόν στις βόρειες περιοχές της Κύπρου Почти все они живут в северных районах Кипра	Τουρκοκύπριοι
JL~a^:Gki6	Ελληνικά::Εξετάσεις - культура и история::Культура	Πώς λεγόταν η Λευκωσία στην αρχαιότητα; Как Никосия называлась в древности?	Λήδρα
tTF~E:>Z&7	Ελληνικά::Εξετάσεις - культура и история::Культура	Τι μοιράζει τη Λευκωσία σε κατεχόμενη και ελεύθερη περιοχή; Что делит Никосию на оккупированную и свободную территорию?	Πράσινη γραμμή Зеленая линия
N4__{qT[;P	Ελληνικά::Εξετάσεις - культура и история::Культура	Πὠς ήταν το όνομα του πρώτου προέδρου της Κυπριακής Δημοκρατίας; Как звали первого президента Кипра?	Αρχιεπίσκοπος Μακάριος ο Γ᾽ Архиепископ Макариос III
o$7X7ER[0:	Ελληνικά::Εξετάσεις - культура и история::Культура	Ποια αρχαία Ελληνική θεά γεννήθηκε στην Κύπρο; Какая древнегреческая богиня родилась на Кипре?	Αφροδίτη
sy=J%k`!z]	Ελληνικά::Εξετάσεις - культура и история::Культура	Πού σύμφωνα με τη μυθολογία γεννήθηκε η Αφροδίτη; Где, согласно мифам, родилась Афродита?	Στην Πέτρα του Ρωμιού У камня Афродиты
p+s%@Tcs);	Ελληνικά::Εξετάσεις - культура и история::Культура	Πότε η Κύπρος πέρασε στην κατοχή των Βρετανών; Когда Кипр перешел под управление британцев?	Το 1878
hCgws+u0@k	Ελληνικά::Εξετάσεις - культура и история::Культура	Πότε η Κύπρος έγινε κράτος μέλος της ΕΕ; Когда Кипр стал членом ЕС?	1 Μαΐου του 2004
J;^69VF-i{	Ελληνικά::Εξετάσεις - культура и история::Культура	Πότε δημιουργήθηκε η Πράσινη γραμμή; Когда была создана Зеленая линия?	Το 1964
Af5?>!~bK7	Ελληνικά::Εξετάσεις - культура и история::Культура	Πότε έγινε η τουρκική εισβολή στην Κύπρο; Когда произошло турецкое вторжение на Кипр?	20 Ιουλίου του 1974
plt6}JXJu}	Ελληνικά::Εξετάσεις - культура и история::Культура	Πώς λεγόταν η τουρκική επιχείρηση για την κατοχή της Κύπρου; Как называлась операция Турции по оккупации Кипра?	Επιχείρηση Αττίλας Операция «Аттила»
cm(eb&A2b@	Ελληνικά::Εξετάσεις - культура и история::Культура	Πότε γιορτάζεται η ανεξαρτησία της Κύπρου; Когда празднуют день независимости Кипра?	1 Οκτωβρίου
h6@UWy6N0h	Ελληνικά::Εξετάσεις - культура и история::Культура	Ποια πόλη είναι κατεχόμενη από τον τουρκικό στρατό; Какой город оккупирован турецкими войсками?	Κερύνεια
fHdHn0!;@`	Ελληνικά::Εξετάσεις - культура и история::Культура	Ποιος αρχαίος φιλόσοφος γεννήθηκε στη Λάρνακα; Какой античный философ родился в Ларнаке?	Ζήνων ο Κιτιεύς Зенон Китийский
"Q&%;#*L-xw"	Ελληνικά::Εξετάσεις - культура и история::Религия	Την Καθαρά … μου αρέσει να πηγαίων στην εξοχή και να πετάω χαρταετό. В Чистый … мне нравится ездить за город и запускать воздушного змея.	Καθαρά Δευτέρα, την πρώτη ημέρα της Σαρακοστής В Чистый понедельник, первый день Великого поста
eb?jBcmfgm	Ελληνικά::Εξετάσεις - культура и история::Религия	Την Κυριακή του Πάσχα όλοι μας μαζευόμαστε γύρω από το γιορτινό τραπέζι, τσουγκρίζουμε τα αβγά και ευχόμαστε «…» В Пасхальное воскресенье мы все собираемся за праздничным столом, стукаемся яйцами и говорим друг другу «…»	Χριστός ανέστη Христос воскресе
fq^&)L5G!|	Ελληνικά::Εξετάσεις - культура и история::Религия	Πώς λέγεται ο Αρχιεπίσκοπος Κύπρου; Как зовут архиепископа Кипрского?	Ο σημερινός Αρχιεπίσκοπος Κύπρου λέγεται Γεώργιος, εξελέγη το Δεκέμβριο του 2022 Действующего архиепископа Кипрского зовут Георгиос, он был избран в декабре 2022 года
dsDuXA4{Es	Ελληνικά::Εξετάσεις - культура и история::Религия	Ο Επιτάφιος που συμβολίζει τον τάφο του Χριστού περιφέρεται στις συνοικίες των πόλεων και χωριών κατά τη Μεγάλη Παρασκευή … Плащаницу, которая символизирует гробницу Христа, обносят по кварталам кипрских городов и деревень в Великую Пятницу …	της Μεγάλης Εβδομάδας, τη Μεγάλη Παρασκευή πριν το Πάσχα Страстной недели, в Великую Пятницу перед Пасхой
H:28cl^DVn	Ελληνικά::Εξετάσεις - культура и история::Религия	Στην τιμή ποιανού αγίου ονομάζουν τα παιδιά στην Κύπρο πιο συχνά; В честь какого святого чаще всего называют детей на Кипре?	Άγιος Ανδρέας Святой Андрей
"B5XXXi{Z#}"	Ελληνικά::Εξετάσεις - культура и история::Религия	Ποιος άγιος σχετίζεται με την παράδοση να φτιάχνουν τη βασιλόπιτα την Πρωτοχρονιά; Какой святой связан с традицией печь новогодний пирог?	Άγιος Βασίλειος Святой Василий
g/g.L]6)i{	Ελληνικά::Εξετάσεις - культура и история::Религия	Ένα αρχαίο έθιμο, το οποίο διατηρήθηκε ως τις μέρες μας, είναι να βγαίνουν τα μικρά παιδία στους δρόμους και να λένε με μουσικά όργανα τα κάλαντα. Πότε γίνεται αυτό; Древний обычай, который сохранился до наших дней, предполагает, что маленькие дети выходят на улицы и исполняют под музыкальные инструмента колядки. Когда это происходит?	Το δωδεκαήμερο των Χριστουγέννων На святках после Рождества
E=bB3jQkw7	Ελληνικά::Εξετάσεις - культура и история::Религия	Ένα από τα πιο χαρακτηριστικά έθιμα της Κύπρου είναι να εκδράμουν οι οικογένειες στην εξοχή και τα παιδία να πετούν χαρταετό. Πότε γίνεται αυτό; Один из самых характерных кипрских обычаев предполагает, что семьи выезжают на природу, где дети запускают воздушного змея. Когда это происходит?	Την Καθαρά Δευτέρα В Чистый понедельник
y!^P4?3kvA	Ελληνικά::Εξετάσεις - культура и история::Религия	Ποια είναι η κυριότερη θρησκεία στην Κύπρο; Какая самая распространенная религия на Кипре?	Ορθοδοξία, Χριστιανισμός Православие, христианство
pmQG4~`Ed+	Ελληνικά::Εξετάσεις - культура и история::Религия	Αποκορύφωση της Μεγάλης Εβδομάδας του Πάσχα είναι να συγκεντρώνονται οι πιστοί στους ναούς, να λαμβάνουν σε λαμπάδες το άγιο φως και να ακολουθούν πυροτεχνήματα κατά τη νύκτα … Кульминация Страстной недели перед Пасхой заключается в том, что верующие собираются в храмах, зажигают свечи от святого огня и запускают фейерверки. Когда это происходит?	Την νύχτα του Μεγάλου Σαββάτου προς την Κυριακή του Πάσχα В ночь с Великой субботы на Пасхальное воскресенье
zf=;7uUUOW	Ελληνικά::Εξετάσεις - культура и история::Религия	…στο χωριό μου γίνεται ένα μεγάλο πανηγύρι στην πλατεία για να γιορτάσουμε την Παναγία. На … в моей деревне проходит большой праздник на площади. Это праздник в честь Богородицы	Την Κοίμηση της Θεοτόκου / Τον Δεκαπενταύγουστο Успение / 15 августа
"Dv2<.5!~?#"	Ελληνικά::Εξετάσεις - культура и история::Религия	Ποιος είναι ο ρόλος του κουμπάρου σε έναν παραδοσιακό κυπριακό γάμο; Какова роль «кумбароса» на традиционной кипрской свадьбе?	Να είναι ο κύριος μάρτυρας Быть главным свидетелем
GT`6u*}J@(	Ελληνικά::Εξετάσεις - культура и история::Религия	Ποια από τα παρακάτω έθιμα σχετίζονται με το Πάσχα, με την Πρωτοχρονιά ή με τα Φώτα; Какие из перечисленных традиций относятся к Пасхе, Новому году или Богоявлению?  Βάψιμο κόκκινων αυγών Окрашивание яиц в красный цветΡίξιμο σταυρού στη θάλασσα Бросание креста в мореΠεριφορά επιταφίου Крестный ход с плащаницейΣπάσιμο ροδιού Разламывание граната	Πάσχα Φώτα БогоявлениеΠάσχα Πρωτοχρονιά Новый год
BA_mW,Uzb:	Ελληνικά::Εξετάσεις - культура и история::Религия	15 Αυγούστου είναι εργάσιμη ημέρα. Σωστό ή λάθος; 15 августа – рабочий день. Правда или ложь?	Λάθος
AqY_FZ6K[F	Ελληνικά::Εξετάσεις - культура и история::Традиции	Πότε οι Κύπριοι φτιάχνουν φλαούνες; Когда киприоты готовят флауны?	το Πάσχα на Пасху. Флауна – традиционная пасхальная выпечка с халлуми
b^ZdCOUo7Q	Ελληνικά::Εξετάσεις - культура и история::Традиции	Τα Λεύκαρα είναι γνωστά με … που έχει προστεθεί στον κατάλογο της Παγκόσμιας κληρονομίας ΟΥΝΕΣΚΟ. Лефкара известна своим …, которое включено в реестр Всемирного наследия ЮНЕСКО.	το λευκαρίτικο κέντημα кружевом «лефкаритико»
Bv?eetjN0@	Ελληνικά::Εξετάσεις - культура и история::Традиции	Πώς ονομάζεται το κέρμα που βάζουν στη βασιλόπιτα; Как называется монетка, которую запекают в василопите?	το φλουρί
bN]@=H5|Y/	Ελληνικά::Εξετάσεις - культура и история::Традиции	Πώς ονομάζεται η πίτα της Πρωτοχρονιάς; Как называется новогодний пирог?	βασιλόπιτα
Nw`^6<EE<q	Ελληνικά::Εξετάσεις - культура и история::Традиции	Ποιό από τα παρακάτω δεν αποτελεί τυπικό φαγητό για το κυπριακό τραπέζι του Πάσχα;Что из нижеперечисленного не входит в число традиционных блюд кипрского пасхального стола?	Φτυτά
br/nR(6II;	Ελληνικά::Εξετάσεις - культура и история::Традиции	Τι είναι οι κουραμπιέδες; Что такое «курабьедес»?	Παραδοσιακό χριστουγεννιάτικο κέρασμα / γλυκό Традиционное рождественское угощенье / сладость
Q&[vz!MI|R	Ελληνικά::Εξετάσεις - культура и история::Традиции	Ποιο έθιμο συνδέεται με την περίοδο της Αποκριάς ή του καρναβαλιού στην Κύπρο;Какой обычай связан с периодом карнавала на Кипре?	Συμμετοχή σε παρέες με μάσκες Обычай собираться компаниями и надевать маски
Hi)}H3Lq+N	Ελληνικά::Εξετάσεις - культура и история::Традиции	Ποιο κυπριακό γλυκό παρασκευάζεται από γάλα, σιμιγδάλι, ζάχαρη και πασπαλίζεται συνήθως με κανέλα;Какую кипрскую сладость готовят из молока, манки, сахара, и обычно посыпают корицей?	το γαλακτομπούρεκο
vQMaj}N+al	Ελληνικά::Εξετάσεις - культура и история::Традиции	Πώς ονομάζεται ο παραδοσιακός χορός που χορεύεται συνήθως στα κυπριακά γλέντια;Как называется традиционный танец, который обычно исполняют на кипрских посиделках?	Συρτός
"o_Ll#L+?ef"	Ελληνικά::Εξετάσεις - культура и история::Традиции	Ποιο είναι το παραδοσιακό κυπριακό ρόφημα που μπορούν να σερβίρουν σε έναν κυπριακό γάμο;Какой традиционный напиток могут подавать на кипрской свадьбе?	κυπριακός καφές
cq^.v{2jZ)	Ελληνικά::Εξετάσεις - культура и история::Традиции	Τι είναι η μαγειρίτσα;Что такое «магирица»?	Παραδοσιακή σούπα με κρέας που τρώγεται το Πάσχα Традиционный мясной суп, который едят на Пасху
G;tV_nGl{P	Ελληνικά::Εξετάσεις - культура и история::Традиции	Σημειώστε αν είναι σωστή ή λανθασμένη η κάθε παρακάτω απάντηση: Отметьте, верно или ложно каждое следующее утверждение:  Σαράντα ημέρες μετά τον θάνατο τελείται μνημόσυνο και φτιάχνουμε κόλλυβο Спустя сорок дней после смерти совершается панихида и готовится коливоΟι Καλλικάντζαροι, σύμφωνα με την παράδοση, είναι τα καλά πνεύματα των Χριστουγέννων που φέρνουν καλοτυχία Калликадзари, согласно традиции, это добрые духи Рождества, которые приносят удачуΌταν ξεκινάει η καινούργια σχολική χρονιά τελούμε αγιασμό В честь начала нового учебного года в школах совершается молебенΌταν κάποιος αρρωσταίνει φτιάχνουμε Φανουρόπιτα για να γίνει καλά Когда кто-то заболевает, мы готовим фануропиту, чтобы человек поправился	Σωστό Λάθος Σωστό Λάθος
f`@e$^W?}5	Ελληνικά::Εξετάσεις - культура и история::Традиции	Πώς λέγεται το παραδοσιακό κυπριακό κρασί;Как называется традиционное кипрское вино?	Κουμανδαρία Коммандария
qWbnR(AiT	Ελληνικά::Εξετάσεις - культура и история::Традиции	Ποιο από τα παρακάτω είναι το πιο χαρακτηριστικό κυπριακό πιάτο;Что из нижеперечисленного представляет собой наиболее характерно кипрское блюдо?	Σούβλα Среди вариантов ответа могут быть греческие блюда типа сувлаки или тарамасалаты, но они пришли на остров с материка, в то время как сувла – местное изобретение
mytKVo>0WQ	Ελληνικά::Εξετάσεις - культура и история::Традиции	Ποια κυπριακή πόλη είναι φημισμένη για τη γιορτή του καρναβαλιού;Какой кипрский город славится празднованием карнавала?	Λεμεσός
IZXa4e{Zxx	Ελληνικά::Εξετάσεις - культура и история::Традиции	Ποια κυπριακή πόλη είναι φημισμένη για τη γιορτή του Κατακλυσμού;Какой кипрской город славится празднованием Катаклизмоса?	Λάρνακα
u+^Azs!]U%	Ελληνικά::Εξετάσεις - культура и история::Традиции	Πότε γιορτάζουν τον Κατακλυσμό;Когда отмечается Катаклизмос?	Τη Δευτέρα της Πεντηκοστής В понедельник после праздника Пятидесятницы
"ilt)hNd#V5"	Ελληνικά::Εξετάσεις - культура и история::Традиции	Ποια είναι η άλλη ονομασία του Κατακλυσμού;Как еще называется праздник Катаклизмос?	Δευτέρα του Αγίου Πνεύματος Понедельник Святого Духа
EM4r};:hiX	Ελληνικά::Εξετάσεις - культура и история::Традиции	Ποιο από τα παρακάτω προϊόντα δεν σχετίζεται με την Κύπρο;Какой из перечисленных продуктов не относится к Кипру?	τυρί φέτα
Iv?k<t&([h	Ελληνικά::Εξετάσεις - культура и история::Традиции	Σε ποια πόλη διεξάγεται η γιορτή του κρασιού;В каком городе проходит фестиваль вина?	Λεμεσός
s^aG3OW4)C	Ελληνικά::Εξετάσεις - культура и история::География	Πώς λέγεται ο μεγαλύτερος ποταμός στην Κύπρο;Как называется самая крупная река Кипра?	Πεδιαίος ποταμός Педиэос
G,De~`RvBF	Ελληνικά::Εξετάσεις - культура и история::География	Ποια είναι η ψηλότερη βουνοκορυφή της Κύπρου;Как называется самая высокая вершина Кипра?	Όρος Όλυμπος Гора Олимп
IWd,tW*M]{	Ελληνικά::Εξετάσεις - культура и история::География	Ποιο είναι το μεγαλύτερο δίκτυο των αλυκών στην Κύπρο;Как называется крупнейшая сеть соленых озер на Кипре?	Αλυκές Λάρνακας Соляные озера Ларнаки
c0IpLA}:CJ	Ελληνικά::Εξετάσεις - культура и история::География	Σημειώστε την γεωγραφική τοποθεσία του δήμου Λευκάρων.Назовите географическое расположение муниципалитета Лефкара.	Επαρχία Λάρνακας Провинция Ларнаки
ozR@.2SeqS	Ελληνικά::Εξετάσεις - культура и история::География	Πώς λέγεται η πρωτεύουσα της Κύπρου;Как называется столица Кипра?	Λευκωσία
hjzp_5!v8K	Ελληνικά::Εξετάσεις - культура и история::География	Πώς λέγεται το εθνικό ζώο της Κύπρου;Как называется национальное животное Кипра?	Αγρινό Муфлон
GditPa[:>u	Ελληνικά::Εξετάσεις - культура и история::География	Ποιο είδος θαλάσσιας χελώνας φωλιάζει στις παραλίες της Κύπρου;Какой вид черепахи гнездится на пляжах Кипра?	Таких видов два: логгерхед (καρέτα καρέτα) и зеленая морская черепаха (πράσινη χελώνα).
A|tI8/@i,B	Ελληνικά::Εξετάσεις - культура и история::География	… στα 1952 μέτρα είναι το υψηλότερο σημείο της Κύπρου.Гора …. Высотой 1952 метра – самая высокая точка Кипра.	Όλυμπος
vpwC7h9&TB	Ελληνικά::Εξετάσεις - культура и история::География	Σημειώστε την πόλη που δεν βρέχεται από τη θάλασσα.Укажите город, который не омывается морем	Λευκωσία
vH^5P4f3-m	Ελληνικά::Εξετάσεις - культура и история::География	Ποια επαρχία έχει τη μεγαλύτερη έκταση;Какая провинция имеет наибольшую площадь?	Επαρχία Λευκωσίας Провинция Никосии 2 728 км2
iOi(W+f3oG	Ελληνικά::Εξετάσεις - культура и история::География	Η Κύπρος είναι το τρίτο μεγαλύτερο νησί της Μεσογείου. Σωστό ή λάθος;Кипр – третий по размерам остров Средиземноморья. Верно или ложно?	Σωστό
bFYP,oir+6	Ελληνικά::Εξετάσεις - культура и история::География	Σε ποια επαρχία βρίσκεται ο δήμος Γεροσκήπου;В какой провинции расположен муниципалитет Героскипу?	Επαρχία Пафоυ Провинция Пафоса
i6KKo.Nt2	Ελληνικά::Εξετάσεις - культура и история::География	Πόσες επαρχίες έχει η Κύπρος;Сколько на Кипре провинций?	Είναι έξι, πήραν τα ονόματά τους από τις μεγαλύτερες πόλεις: Λευκωσία, Πάφος, Λεμεσός, Λάρνακα, Αμμόχωστος, Κερύνεια Шесть, они названы по именам центральных городов: Никосии, Пафоса, Лимассола, Ларнаки, Фамагусты, Керинии
Par2iMt@.l	Ελληνικά::Εξετάσεις - культура и история::География	Σε ποια περιοχή βρίσκεται η μονή αγίου Νικολάου των Γάτων;В каком районе находится монастырь святого Николая Кошачьего?	Στην περιοχή Ακρωτηρίου В районе Акротири
M(f{u0yfFi	Ελληνικά::Εξετάσεις - культура и история::География	Ποια πόλη λέγεται αλλιώς Σκάλα;Какой город иначе называется Скала?	Λάρνακα
kwF6JHg3z<	Ελληνικά::Εξετάσεις - культура и история::География	Ποια πόλη λέγεται αλλιώς Χώρα;Какой город иначе называется Хора?	Λευκωσία
k?krj.lNO{	Ελληνικά::Εξετάσεις - культура и история::География	Σε ποιο μέρος της Ανατολικής Μεσογείου βρίσκεται η Κύπρος;В какой части Восточного Средиземноморья находится Кипр?	Στο βορειοανατολικό В северо-восточной
mtA=t,u^Hn	Ελληνικά::Εξετάσεις - культура и история::География	Σε ποια επαρχία βρίσκεται η Άγια Νάπα;В какой провинции находится Айя-Напа?	Επαρχία Αμμοχώστου Провинция Фамагуста
y<X/lWqp<A	Ελληνικά::Εξετάσεις - культура и история::География	Σε ποια επαρχία βρίσκεται η Πόλις Χρυσοχούς;В какой провинции находится Полис Хрисохус?	Επαρχία Πάφου Провинция Пафоса
E.IXiWbS3H	Ελληνικά::Εξετάσεις - культура и история::География	Ποια χώρα βρίσκεται στην πιο κοντινή απόσταση από την Κύπρο;Какая страна ближе всего к Кипру?	Τουρκία
A*jD|/cM&M	Ελληνικά::Εξετάσεις - культура и история::География	Που βρίσκονται οι Πλάτρες;Где расположен Платрес?	Τρόοδος
Is8Z&(.Awa	Ελληνικά::Εξετάσεις - культура и история::Политика	Ποιο είναι το σύνηθες διάστημα μεταξύ των εκλογών του Προέδρου της Δημοκρατίας;Какой стандартный срок между выборами президента Республики Кипр?	Το σύνηθες διάστημα είναι πέντε χρόνια Стандартный срок президентских полномочий – пять лет
lCAt4!jlag	Ελληνικά::Εξετάσεις - культура и история::Политика	Πόσοι υποψήφιοι μπορούν να συμμετέχουν στις εκλογές για τον Πρόεδρο της Δημοκρατίας;Сколько кандидатов могут участвовать в выборах президента Кипра?	Δεν υπάρχει περιορισμός. Το Σύνταγμα της Κυπριακής Δημοκρατίας με το άρθρο 39.1 καθορίζει ότι εάν εμφανισθεί μόνο ένας υποψήφιος, τούτος ανακηρύσσεται ως εκλεγείς Нет ограничений. Конституция в ст. 39.1 оговаривает, что если всего один кандидат претендует на пост президента, то он объявляется избранным
uT_9(kNWx!	Ελληνικά::Εξετάσεις - культура и история::Политика	Ποιος εκλέγεται απευθείας από το λαό στις εκλογές του Προέδρου της Δημοκρατίας;Кто выбирается напрямую народом на президентских выборах?	Πρόεδρος Президент
"C-hOO%x.#D"	Ελληνικά::Εξετάσεις - культура и история::Политика	Ποιος οργανώνει τις εκλογές του Προέδρου της Δημοκρατίας;Кто организует выборы президента Кипра?	Κεντρική Υπηρεσία Εκλογών Центральная избирательная служба
pfCyJ0q}VJ	Ελληνικά::Εξετάσεις - культура и история::Политика	Ποιος έχει τις αρμοδιότητες να διορίζει το Υπουργικό Συμβούλιο;Кто обладает полномочиями назначать Совет министров?	Πρόεδρος Президент
"EZHJ9w#)%R"	Ελληνικά::Εξετάσεις - культура и история::Политика	Ποιοι έχουν το δικαίωμα να ψηφίζουν στις εκλογές του Προέδρου της Δημοκρατίας;Кто имеет право голосовать на выборах президента Кипра?	Μόνο οι Κύπριοι πολίτες Только граждане Кипра
q5Xq@rTz!`	Ελληνικά::Εξετάσεις - культура и история::Политика	Από ποια ηλικία ένας πολίτης της Δημοκρατίας έχει δικαίωμα να ψηφίσει στις εκλογές;С какого возраста гражданин Кипра получает право голосовать на выборах президента?	18 χρονών
O6d-eW5pf%	Ελληνικά::Εξετάσεις - культура и история::Политика	Ποιοι από τους πολίτες της Δημοκρατίας δεν μπορούν να ψηφίσουν στις εκλογές του Προέδρου της Δημοκρατίας;Кто из граждан не имеет права голосовать на выборах президента?	Άτομα κάτω των 18 ετών Лица младше 18 лет
n9w]MuFMr$	Ελληνικά::Εξετάσεις - культура и история::Политика	Ποιοι πολίτες έχουν το δικαίωμα να ψηφίσουν στις εκλογές του Προέδρου της Δημοκρατίας αν έχουν εγκαταλείψει τη χώρα για λόγους απασχόλησης ή σπουδών;Кто имеет право голосовать на выборах президента Кипра в случае отсутствия в стране по причине работы или учебы?	Όλοι οι πολίτες της Κύπρου Все граждане Кипра
xao*aG.7ki	Ελληνικά::Εξετάσεις - культура и история::Политика	Ποιο είναι το πολιτικό καθεστώς της Κυπριακής Δημοκρατίας σύμφωνα με το Σύνταγμα;Какая на Кипре форма правления согласно Конституции?	Προεδρική Δημοκρατία Президентская республика
M~U9+a/w,6	Ελληνικά::Εξετάσεις - культура и история::Политика	Ποιος φορέας έχει την εξουσία να τροποποιεί το Σύνταγμα;Какой орган обладает полномочиями вносить изменения в Конституцию?	Βουλή Парламент
"OFi5`B0#{^"	Ελληνικά::Εξετάσεις - культура и история::Политика	Ποια είναι η επίσημη ονομασία των ενόπλων δυνάμεων της Κύπρου;Как официально называются вооруженные силы на Кипре?	Εθνική Φρουρά Национальная гвардия
K3ho^1h*+Z	Ελληνικά::Εξετάσεις - культура и история::Политика	Ποιος είναι ο ρόλος της Εθνικής Φρουράς;Какова на Кипре роль Национальной гвардии?	Εσωτερική ασφάλεια και άμυνα Внутренняя безопасность и оборона
x,dtQ(X)nl	Ελληνικά::Εξετάσεις - культура и история::Политика	Ποια είναι η ηλικία κατάταξης στην υποχρεωτική στρατιωτική θητεία;Каков возраст призыва на обязательную военную службу на Кипре?	18 ετών
N/MHuh^dH.	Ελληνικά::Εξετάσεις - культура и история::Политика	Ποιο είναι το κύριο έμβλημα της Εθνικής Φρουράς;Какая главная эмблема Национальной гвардии?	Δικέφαλος αετός Двуглавый орел
oI$b9do|PE	Ελληνικά::Εξετάσεις - культура и история::Политика	Το Υπουργικό Συμβούλιο διορίζεται από…Совет министров назначается …	τον Πρόεδρο της Δημοκρατίας президентом
oq_wsg.fq_	Ελληνικά::Εξετάσεις - культура и история::Политика	Τα μέλη της Βουλής εκλέγονται απευθείας από … για πενταετή θητεία.Члены парламента избираются напрямую … сроком на пять лет.	τον λαό народом
f<e]6]SSsR	Ελληνικά::Εξετάσεις - культура и история::Политика	Ποιος είναι ο ανώτατος δικαστής στην Κύπρο;Кто выступает судом высшей инстанции на Кипре?	Ανώτατο Δικαστήριο Верховный суд
mG}]J:oC2{	Ελληνικά::Εξετάσεις - культура и история::Политика	Ποια είναι η αρμοδιότητα του Ανώτατου Δικαστηρίου της Κύπρου;Каковы полномочия Верховного суда на Кипре?	Αναίρεση αποφάσεων των κατώτερων δικαστηρίων Пересмотр решений судов нижестоящих инстанций
F%BoS<VjLD	Ελληνικά::Εξετάσεις - культура и история::Политика	Ποιος είναι ο ρόλος της Βουλής στην Κύπρο;Какова роль парламента на Кипре?	Να νομοθετεί και να καθορίζει τις πολιτικές κατευθύνσεις της χώρας Заниматься законотворчеством и определять политическое направление страны
r=O;FI4F7/	Ελληνικά::Εξετάσεις - культура и история::Политика	Πόσους βουλευτές έχει η Βουλή;Сколько депутатских мест в кипрском парламенте?	Είναι 80. 56 είναι οι αντιπρόσωποι των Ελληνοκύπριων και 24 των Τουρκοκύπριων. Από το 1963 οι θέσεις των Τουρκοκύπριων βουλευτών είναι κενές 80. Из них 56 принадлежат греко-киприотам, а 24 – турко-киприотам. С 1963 года места турко-кипрских депутатов вакантны
rE~6hZLrdc	Ελληνικά::Εξετάσεις - культура и история::Политика	Ποιος είναι ο χρόνος θητείας ενός μέλους της Βουλής;Каков срок полномочий члена парламента на Кипре?	5 χρόνια
DOZ]scrbEf	Ελληνικά::Εξετάσεις - культура и история::Политика	Ποια είναι οι διαδικασία εκλογής των μελών της Βουλής;Какова процедура выбора членов кипрского парламента?	Άμεση εκλογή από τους πολίτες με βάση το προσωπικό ψηφοδέλτιο Напрямую гражданами на основе личного избирательного бюллетеня
"zfzs[zTe#{"	Ελληνικά::Εξετάσεις - культура и история::Политика	Η πρώτη γυναίκα πρόεδρος της Βουλής από την ίδρυση της Κυπριακής Δημοκρατίας το 1960 είναι …Первая женщина – спикер парламента с момента основания Республики Кипр в 1960 году – это…	Η Αννίτα Δημητρίου
ji]%Uzypd}	Ελληνικά::Εξετάσεις - культура и история::Политика	Κανένα άλλο κράτος εκτός από την Τουρκία δεν αναγνωρίζει τη λεγόμενη ῾Τουρκική Δημοκρατία Βόρειου Κύπρου῾. Σωστό ή λάθος;Никакое другое государство, кроме Турции, не признает так называемую Турецкую Республику Северного Кипра. Верно или нет?	Σωστό
orq`%=zT4=	Ελληνικά::Εξετάσεις - культура и история::Политика	Πόσους βουλευτές έχει η Κύπρος στο Ευρωπαϊκό Κοινοβούλιο;Сколько депутатов от Кипра в Европарламенте?	6
F0=]2W/YH:	Ελληνικά::Εξετάσεις - культура и история::Политика	Ποιες είναι οι επίσημες γλώσσες στην Κύπρο;Какие официальные языки на Кипре?	Ελληνικά και τούρκικα
Qt<.%~^D7>	Ελληνικά::Εξετάσεις - культура и история::Политика	Σε ποια από τις παρακάτω οργανώσεις δεν είναι μέλος η Κύπρος;Членом какой из перечисленных организации Кипр не является?	ΝΑΤΟ
k=R{dfkrRg	Ελληνικά::Εξετάσεις - культура и история::Ведомства и инфраструктура	Τι σημαίνει το ακρωνύμιο ΚΕΠ; Что значит аббревиатура КЕП?	Κέντρο Εξυπηρέτησης του Πολίτη Центр обслуживания граждан
mL10}m)FFQ	Ελληνικά::Εξετάσεις - культура и история::Ведомства и инфраструктура	Ποιο υπουργείο είναι υπεύθυνο για τη λειτουργία των ΚΕΠ;Какое ведомство отвечает за работу КЕП?	Υπουργείο Οικονομικών Министерство финансов
kMN[dY0fmZ	Ελληνικά::Εξετάσεις - культура и история::Ведомства и инфраструктура	Ποιο είναι το βασικό πλεονέκτημα των ΚΕΠ στην Κύπρο;Какое основное преимущество центров обслуживания граждан на Кипре?	Παροχή γρήγορων και ευκολότερων διαδικασιών στους πολίτες Предоставление быстрых и упрощенных процедур гражданам
LcgBV`dw6R	Ελληνικά::Εξετάσεις - культура и история::Ведомства и инфраструктура	Πού μπορεί κανείς να βρει τα ΚΕΠ;Где можно найти центры обслуживания граждан?	Σε όλες τις μεγάλες πόλεις και χωριά της Κύπρου Во всех крупных городах и селениях Кипра
E]LGPrl/Eh	Ελληνικά::Εξετάσεις - культура и история::Ведомства и инфраструктура	Ποια είναι η λειτουργία του ΓεΣΥ στην Κύπρο;В чем функция Генеральной системы медицинского обслуживания (ГеСИ) на Кипре?	Υπεύθυνη για την παροχή υπηρεσιών υγείας στους πολίτες της Κύπρου Отвечать за предоставление услуг здравоохранения гражданам Кипра
ySg;?fZ_lE	Ελληνικά::Εξετάσεις - культура и история::Ведомства и инфраструктура	Ποιο υπουργείο είναι υπεύθυνο για τη λειτουργία του ΓεΣΥ;Какое министерство отвечает за работу ГеСИ?	Υπουργείο Υγείας Министерство здравоохранения
yTsi-;)vX	Ελληνικά::Εξετάσεις - культура и история::Ведомства и инфраструктура	Ποιες υπηρεσίες παρέχονται στα πλαίσια του ΓεΣΥ;Какие услуги предоставляются в рамках ГеСИ?	Παροχή ιατρικών εξετάσεων και περίθαλψης Медицинские осмотры и уход
v:FPP$4IZ<	Ελληνικά::Εξετάσεις - культура и история::Ведомства и инфраструктура	Πού μπορούν οι κάτοικοι της Κύπρου να λάβουν πληροφορίες για το ΓεΣΥ;Где жители Кипра могут получить информацию о ГеСИ?	Στον επίσημο ιστότοπο του ΓΕΣΥ На официальном портале ГеСИ
"Av1Xr#.L9%"	Ελληνικά::Εξετάσεις - культура и история::Ведомства и инфраструктура	Ποιος είναι ο ρόλος της αστυνομίας στην Κύπρο;Какова роль полиции на Кипре?	Διασφάλιση της δημόσιας τάξης, της ασφάλειας και της εφαρμογής του νόμου Обеспечение общественного порядка, безопасности и законоприменения
l>a`~X79.X	Ελληνικά::Εξετάσεις - культура и история::Ведомства и инфраструктура	Ποιος είναι ο ρόλος του αρχηγού της αστυνομίας στην Κύπρο;Какова роль шефа полиции на Кипре?	Να διευθύνει την αστυνομική δράση και τις επιχειρήσεις Руководить действиями полиции и операциями
seg1q9R5;O	Ελληνικά::Εξετάσεις - культура и история::Ведомства и инфраструктура	Ποιες είναι οι βασικές αρμοδιότητες της αστυνομίας στην Κύπρο;Каковы основные полномочия полиции на Кипре?	Προστασία της δημόσιας τάξης και καταπολέμηση του εγκλήματος Защита общественного порядка и борьба с преступностью
c_jC>,Qy7h	Ελληνικά::Εξετάσεις - культура и история::Ведомства и инфраструктура	Πού μπορούν να απευθυνθούν οι κάτοικοι για να αναφέρουν ένα περιστατικό ή να ζητήσουν τη βοήθεια της αστυνομίας;Куда жители могут обратиться, чтобы сообщить об инциденте или попросить помощи полиции?	Σε αστυνομικά τμήματα και κεντρικό αστυνομικό σταθμό В отделения полиции и центральное полицейское управление
jJ%&!AEl9%	Ελληνικά::Εξετάσεις - культура и история::Ведомства и инфраструктура	Τι είναι η ΑΗΚ;Что такое ΑΗΚ?	Αρχή Ηλεκτρισμού Κύπρου. Ο φορέας παραγωγής και διανομής ηλεκτρικής ενέργειας στην Κύπρο Управление электроэнергии Кипра. Это организация по производству и распределению электроэнергии на Кипре
y//YFxp*go	Ελληνικά::Εξετάσεις - культура и история::Ведомства и инфраструктура	Ποιες είναι οι βασικές αρμοδιότητες της ΑΗΚ;Каковы основные полномочия Управления электроэнергии Кипра?	Παραγωγή, διανομή και πώληση ηλεκτρικής ενέργειας στην Κύπρο Производство, распространение и продажа электроэнергии на Кипре
>k6yJYib1	Ελληνικά::Εξετάσεις - культура и история::Ведомства и инфраструктура	Πού μπορούν οι κάτοικοι να απευθυνθούν για να λύσουν προβλήματα ηλεκτροδότησης;Куда жители Кипра могут обратиться, чтобы решить проблемы с подачей электроэнергии?	Στα επαρχιακά γραφεία της ΑΗΚ В региональные офисы Управления электроэнергии Кипра
g<[jizhCA@	Ελληνικά::Εξετάσεις - культура и история::Ведомства и инфраструктура	Ποιες είναι οι βασικές υπηρεσίες που προσφέρει το Ταχυδρομείο στην Κύπρο;Какие основные услуги предлагает почта на Кипре?	Παράδοση γραμμάτων και δεμάτων Выдача писем и посылок
tkrT.qFt0=	Ελληνικά::Εξετάσεις - культура и история::Ведомства и инфраструктура	Ποια είναι η διαδικασία παραλαβής ενός πακέτου από το ταχυδρομείο;Какова процедура получения посылки на почте?	Προσέλευση στον κεντρικό χώρο ταχυδρομικής διανομής της πόλης Визит в центральный почтовый офис города
bVVK2WauS$	Ελληνικά::Εξετάσεις - культура и история::Ведомства и инфраструктура	Ποια είναι η βασική αποστολή της Πυροσβεστικής Υπηρεσίας στην Κύπρο;Какова основная миссия Пожарной службы Кипра?	Πρόληψη και καταπολέμηση των πυρκαγιών Профилактика и тушение пожаров
e!:D^/W0M$	Ελληνικά::Εξετάσεις - культура и история::Ведомства и инфраструктура	Ποιος είναι ο αρμόδιος φορέας για την κλήση της Πυροσβεστικής Υπηρεσίας σε περίπτωση πυρκαγιάς;Кто выступает компетентным органом для вызова пожарной службы в случае пожара?	Κέντρο έκτακτης ανάγκης Центр чрезвычайных ситуаций
A=|lJ]yH&P	Ελληνικά::Εξετάσεις - культура и история::Ведомства и инфраструктура	Ποια η επίσημη γλώσσα που χρησιμοποιείται στις δημόσιες υπηρεσίες;Какой официальный язык используется в государственных ведомствах Кипра?	Ελληνικά
k(%ecA608j	Ελληνικά::Εξετάσεις - культура и история::Ведомства и инфраструктура	Πώς λέγεται ο εθνικός φορέας της τηλεπικοινωνίας στην Κύπρο;Как называется национальный орган телекоммуникаций на Кипре?	Английская аббревиатура CyTA, греческая аббревиатура той же организации – ΑΤΗΚ (Αρχή Τηλεπικοινωνίας Κύπρου)
AQQ,9@i$eC	Ελληνικά::Εξετάσεις - культура и история::Ведомства и инфраструктура	Ποιος είναι ο κυπριακός οργανισμός που ασχολείται με την ασφάλεια και την υγεία στον εργασιακό χώρο;Вопрос: Какое кипрское ведомство занимается безопасностью и здравоохранением на рабочем месте?	Τμήμα Επιθεώρησης Εργασίας Департамент инспекции труда
yV@8d.pSH6	Ελληνικά::Εξετάσεις - культура и история::Ведомства и инфраструктура	Ποιο είναι το κύριο διεθνές αεροδρόμιο της Κύπρου;Назовите основной международный аэропорт Кипра?	Διεθνές αεροδρόμιο Λάρνακας ῾Γλαύκος Κληρίδης῾ Международный аэропорт Ларнаки имени Глафкоса Клиридиса
F$955!ehYh	Ελληνικά::Εξετάσεις - культура и история::Ведомства и инфраструктура	Πώς λέγεται ο εθνικός αεροπορικός μεταφορέας της Κύπρου;Как называется национальный авиаперевозчик Кипра?	Cyprus Airways
HAjJ7Tep+o	Ελληνικά::Εξετάσεις - культура и история::Ведомства и инфраструктура	Ποιο αεροδρόμιο βρίσκεται πιο κοντά στην πόλη της Λευκωσίας;Какой аэропорт расположен ближе всего к Никосии?	Аэропорт Никосии (Αεροδρόμιο Λευκωσίας). Если в вопросе есть уточнение «действующий аэропорт», тогда это аэропорт Ларнаки
"I94K;(y##q"	Ελληνικά::Εξετάσεις - культура и история::Ведомства и инфраструктура	Ποιο αεροδρόμιο εξυπηρετεί κυρίως τις τουριστικές περιοχές της επαρχίας Πάφου;Какой аэропорт обслуживает туристические районы Пафоса?	Αεροδρόμιο Πάφου
AXTvmVg2wo	Ελληνικά::Εξετάσεις - культура и история::Ведомства и инфраструктура	Ποιο υπουργείο είναι υπεύθυνο για την οικονομία της Κύπρου;Какое министерство отвечает за кипрскую экономику?	Υπουργείο Οικονομικών Министерство финансов
vRR7q(p.]B	Ελληνικά::Εξετάσεις - культура и история::Ведомства и инфраструктура	Το μεγαλύτερο λιμάνι της Κύπρου είναι …Крупнейший порт Кипра – это…	Λιμάνι Λεμεσού Порт Лимассола
uM:OrVjGBh	Ελληνικά::Εξετάσεις - культура и история::Ведомства и инфраструктура	Οι μετανάστες αποτελούν 5% του πληθυσμού της Κύπρου. Σωστό ή λάθος;Мигранты составляют 5% населения. Верно или ложно?	Λάθος
PDd0RiyHOW	Ελληνικά::Εξετάσεις - культура и история::Ведомства и инфраструктура	Ο ΦΠΑ σε ψωμί, γάλα και αυγά είναι πλέον 0%. Σωστό ή λάθος;НДС на хлеб, молоко и яйца сейчас составляет 0%. Верно или ложно?	Σωστό
PXORyvc}DR	Ελληνικά::Εξετάσεις - культура и история::Ведомства и инфраструктура	Το ωράριο λειτουργίας των δημόσιων υπηρεσιών είναι από 07:30 εὠς 16:00. Σωστό ή λάθος;Часы работы государственных учреждений с 07:30 до 16:00. Верно или ложно?	Λάθος
i,oX@bj`ku	Ελληνικά::Εξετάσεις - культура и история::Ведомства и инфраструктура	Το τηλέφωνο της Αστυνομίας και της Πυροσβεστικής είναι 225. Σωστό ή λάθος;Телефон полиции и пожарной службы – 225?	Λάθος, το τηλέφωνό τους είναι 112
"sCTzl#/guZ"	Ελληνικά::Εξετάσεις - культура и история::Ведомства и инфраструктура	Εάν παίρνετε στο εξωτερικό 10 χιλιάδες ευρώ και άνω πρέπει να τα δηλώσετε. Σωστό ή λάθος;Если вы намерены вывезти с Кипра 10 тысяч евро и более, то вам необходимо их задекларировать. Верно или ложно?	Σωστό
QTN]lom:Z5	Ελληνικά::Εξετάσεις - культура и история::Ведомства и инфраструктура	Με ποιο μέσο μεταφοράς δεν μπορεί να φθάσει ένας τουρίστας από τη Λεμεσό στη Λευκωσία;На чем турист не может добраться до Лимасола из Никосии?	Με το τραίνο На поезде
i,f335VKQ?	Ελληνικά::Εξετάσεις - культура и история::Ведомства и инфраструктура	Ποιος είναι ο τηλεφωνικός κώδικας της Κύπρου;Какой телефонный код Кипра?	+357
B8KQ9tN2R^	Ελληνικά::Εξετάσεις - культура и история::Ведомства и инфраструктура	Πόσο είναι το κόστος της επίσκεψης προσωπικού γιατρού μέσω ΓεΣΥ;Какова стоимость визита к частному врачу по ГЕСИ?	0
r0sMJ)NVMI	Ελληνικά::Εξετάσεις - культура и история::Ведомства и инфраструктура	Ποιο είναι το μεγαλύτερο επιτρεπόμενο όριο ταχύτητας στον αυτοκινητόδρομο;Какая максимальная допустимая скорость на трассе?	100 км/ч
Aq4!28@yem	Ελληνικά::Εξετάσεις - культура и история::Словарный запас	-Σήμερα έχω τα … μου. Γίνομαι 12 χρονών. -Αλήθεια; Χρόνια πολλά! Να τα εκατοστίσεις. –Сегодня у меня … Мне 12 лет. –Правда? С праздником! Живи в сто раз больше.	τα γενέθλια день рождения
bgUa[F]^qo	Ελληνικά::Εξετάσεις - культура и история::Словарный запас	Στην Κύπρο σαράντα μέρες πριν το Πάσχα …, δεν τρώμε δηλαδή κρέας, γάλα και αβγά.На Кипре за 40 дней до Пасхи мы …, то есть не едим мяса, молока и яиц	νηστεύουμε постимся
"Qk2)#o~f!-"	Ελληνικά::Εξετάσεις - культура и история::Словарный запас	Χθες στα γενέθλια του Πέτρου … πολύ. Φάγαμε, ήπιαμε και χορέψαμε. Ήταν πολύ ωραία.Вчера на дне рождения Петроса мы хорошо ….. Мы ели, пили и танцевали. Было очень здорово	διασκεδάσαμε повеселились
jr8Cq]J*.W	Ελληνικά::Εξετάσεις - культура и история::Словарный запас	Φέτος η τάξη μας συμμετέχει στην … της γιορτής του 28 Οκτωβρίου. Εγώ θα είμαι στην πρώτη γραμμή.В этом году наш класс участвует в … в честь праздника 28 октября. Я буду в первом ряду	παρέλαση параде
O9@`B`_}fn	Ελληνικά::Εξετάσεις - культура и история::Словарный запас	Την … των Χριστουγέννων τα παιδιά βγαίνουν στους δρόμους και λένε τα κάλαντα.В …. Рождества дети выходят на улицы и исполняют колядки.	παραμονή канун
o4Djx[9m*^	Ελληνικά::Εξετάσεις - культура и история::Словарный запас	Το Μεγάλο Σάββατο το βράδυ όλοι βάζουμε τα καλά μας και πάμε στην εκκλησία για να γιορτάσουμε την … του Χριστού.Вечером Великой субботы мы нарядно одеваемся и идем в церковь, чтобы отпраздновать … Христово.	Ανάσταση Воскресение
v`p>MOfM79	Ελληνικά::Εξετάσεις - культура и история::Словарный запас	Φέτος … θέλω να ντυθώ πολεμιστήςВ этом году на … я хочу одеться воином	το καρναβάλι / τις απόκριες
JAm&Cucp$D	Ελληνικά::Εξετάσεις - культура и история::Словарный запас	-Πότε είναι η γιορτή σου, Αλέξανδρε; -Στις 30 Αυγούστου. Δεν το ξέρεις; Γιορτάζουν … όλοι οι Αλέξανδροι.  -Когда ты празднуешь, Александрос?  -30 августа. Ты разве не знаешь? Все Александры отмечают в этот день …	ονομαστική γιορτή именины
E(>.2L}A$:	Ελληνικά::Επίπεδο Β1::Επιπλέον / Дополнительно	диплом	το πτυχίο
I`:&~L&>=n	Ελληνικά::Επίπεδο Β1::Τα ρήματα / Глаголы	связываюсь (например, по эл. почте)	επικοινωνώ, επικοινώνησα, θα επικοινωνήσω
OM9-1LOt}@	Ελληνικά::Επίπεδο Β1::Επιπλέον / Дополнительно	знаю, узнаю	γνωρίζω, γνώρισα, θα γνωρίσω
xTAv+8.ePb	Ελληνικά::Επίπεδο Β1::Επιπλέον / Дополнительно	угощаю	κερνάω, κέρασα, θα κεράσω
"Q]TP#:I!i0"	Ελληνικά::Επίπεδο Β1::Τα ρήματα / Глаголы	рекомендую, представляю (кого-то кому-то)	συστήνω, σύστησα, θα συστήσω
MF~gVHi}[;	Ελληνικά::Επίπεδο Β1::Τα ρήματα / Глаголы	беспокою	ενοχλώ, ενόχλησα, θα ενοχλήσω
mL>T,c+QxT	Ελληνικά::Επίπεδο Β1::Επιπλέον / Дополнительно	иностранец	ο αλλοδαπός, η αλλοδαπή
P]d~*`[*;H	Ελληνικά::Επίπεδο Β1::Επιπλέον / Дополнительно	хаос, суматоха, потеря	ο χαμός
Kd!/u7Hwe=	Ελληνικά::Επίπεδο Β1::Επιπλέον / Дополнительно	удобный	ο άνετος, η άνετη
FPzkKTPdbE	Ελληνικά::Επίπεδο Α2::Η μουσική / Музыка	наушники	τα ακουστικά
f:D)%}{!tL	Ελληνικά::Επίπεδο Α2::Επιπλέον / Дополнительно	руль	το τιμόνι
vGYub1XrYC	Ελληνικά::Επίπεδο Β1::Επιπλέον / Дополнительно	штраф	το πρόστιμο
E,mG`M8VT-	Ελληνικά::Επίπεδο Β1::Τα ρήματα / Глаголы	чиню, ремонтирую	επισκευάζω, επισκεύασα, θα επισκευάσω
s$etNG%M%b	Ελληνικά::Επίπεδο Β1::Επιπλέον / Дополнительно	повреждение, поломка	η ζημία
ffXmq`*TUU	Ελληνικά::Επίπεδο Β1::Τα ρήματα / Глаголы	переезжаю / переезд	μετακομίζω, μετακόμισα, θα μετακομίσω / η μετακόμιση
xmTh+C5UXa	Ελληνικά::Επίπεδο Β1::Επιπλέον / Дополнительно	просторный (напр. дом)	ο ευρύχωρος
E&(1;~+RW6	Ελληνικά::Επίπεδο Β1::Επιπλέον / Дополнительно	приближаюсь	κοντεύω, κόντεψα, θα κοντέψω
xhFwU^s1?H	Ελληνικά::Επίπεδο Β1::Επιπλέον / Дополнительно	сосед (по комнате, сожитель)	ο/η συγκάτοικος
rG`g1*&Z,N	Ελληνικά::Επίπεδο Β1::Επιπλέον / Дополнительно	выбор	η επιλογή
OC/?k[qN^n	Ελληνικά::Επίπεδο Β1::Επιπλέον / Дополнительно	направление	η κατεύθυνση
r?SgEr81BU	Ελληνικά::Επίπεδο Β1::Επιπλέον / Дополнительно	штраф	το πρόστιμο
e{aQC&gS@)	Ελληνικά::Επίπεδο Β1::Επιπλέον / Дополнительно	полёт, авиарейс	η πτήση
"PB.#vL$E,$"	Ελληνικά::Ρήματα::Τύπος Α	покупаю	αγοράζω, αγόρασα, θα αγοράσω
fVr(dhjn5&	Ελληνικά::Επίπεδο Β1::Τα ζώα / Животные	кормить	ταΐζω, τάισα, θα ταΐσω
g`jPHJo$+o	Ελληνικά::Επίπεδο Β1::Τα ζώα / Животные	эмпатия	η εμπάθεια
tqZq=`?kTp	Ελληνικά::Επίπεδο Β1::Τα ζώα / Животные	приюты для животных	τα καταφύγια ζώων
JVW@yXYv(2	Ελληνικά::Επίπεδο Β1::Τα ζώα / Животные	реклама	η διαφήμιση
"OW(?~?YK4#"	Ελληνικά::Επίπεδο Β1::Τα ζώα / Животные	умерший	πεθαμένος
k9(B:]JyfU	Ελληνικά::Επίπεδο Β1::Τα ζώα / Животные	мёртвый	νεκρός
c[h-T8u[A6	Ελληνικά::Επίπεδο Β1::Τα ζώα / Животные	ограждение, забор	τα κάγκελα
d>1kVJ=+Xq	Ελληνικά::Επίπεδο Β1::Τα ζώα / Животные	забирать из приюта, усыновлять	υιοθετώ, υιοθέτησα, θα υιοθετήσω
k81L92?Pxd	Ελληνικά::Επίπεδο Β1::Τα ζώα / Животные	сообщить, упоминать	αναφέρω, ανέφερα, θα αναφέρω
B]>.VQnh`$	Ελληνικά::Επίπεδο Β1::Τα ζώα / Животные	участвовать	συμμετέχω, συμμετείχα, θα συμμετάσχω
y}/X-W^}ad	Ελληνικά::Επίπεδο Β1::Τα ζώα / Животные	волонтёр	ο εθελοντής
AY6gXl:vKf	Ελληνικά::Επίπεδο Β1::Τα ζώα / Животные	плохое обращение с животными	η άγρια συμπεριφορά στα ζώα 
fe}U0`Ea*C	Ελληνικά::Επίπεδο Β1::Τα ζώα / Животные	клетка	το κλουβί
"J#x;fG5vwS"	Ελληνικά::Επίπεδο Β1::Τα ζώα / Животные	развлекательный	διασκεδαστικό
Ef;nzNb$yW	Ελληνικά::Επίπεδο Β1::Τα ζώα / Животные	коррида	η ταυρομαχία
tQi4_g&7c]	Ελληνικά::Επίπεδο Β1::Τα ζώα / Животные	страдать	υποφέρω, υπέφερα, θα υποφέρω
t|Mmd3tn_7	Ελληνικά::Επίπεδο Β1::Τα ζώα / Животные	это возможно	αυτό είναι δυνατόν
s~[<KTP}j7	Ελληνικά::Επίπεδο Β1::Τα ζώα / Животные	этично	ηθικό
x+_>?;-bob	Ελληνικά::Επίπεδο Β1::Τα ζώα / Животные	кинолог	ο κυνολόγος
Ek8qtey6WX	Ελληνικά::Επίπεδο Β1::Τα ζώα / Животные	воспитание, обучение	η εκπαίδευση 
jZUG+%v=h<	Ελληνικά::Επίπεδο Β1::Τα ζώα / Животные	действие	η δράση 
qD7aKV,I+L	Ελληνικά::Επίπεδο Β1::Τα ζώα / Животные	исчезающие, вымирающие	τα εξαφανισμένα
"f$HQrX#{y:"	Ελληνικά::Επίπεδο Β1::Τα ζώα / Животные	исследование	η έρευνα
KSuIY7%.Z?	Ελληνικά::Επίπεδο Β1::Τα ζώα / Животные	излечиться	γιατρεύομαι, γιατρεύτηκα, θα γιατρευτώ
LK?7+nhyQ<	Ελληνικά::Επίπεδο Β1::Τα ζώα / Животные	защищать виды животных	προστατεύω τα είδη των ζώων
"q}#2_5-A<7"	Ελληνικά::Επίπεδο Β1::Η συζήτηση, εκφράσεις / Беседа, фразы	оставь, не хочу об этом	ας' τα
C?@gTm?jqU	Ελληνικά::Επίπεδο Β1::Η συζήτηση, εκφράσεις / Беседа, фразы	было бы хорошо / было бы правильно	θα ήταν καλά / θα ήταν σωστό 
F-eh0!FA!y	Ελληνικά::Επίπεδο Β1::Η συζήτηση, εκφράσεις / Беседа, фразы	в конце концов	πάντως 
yE|vs,E_}Y	Ελληνικά::Επίπεδο Β1::Η συζήτηση, εκφράσεις / Беседа, фразы	лучшее из того, что было	η καλύτερη επιλογή που έχουμε 
ll6Yxn=iX9	Ελληνικά::Επίπεδο Β1::Ψώνια / Шоппинг	το μεροκάματο	дневная оплата
s>hhQ&Y:4|	Ελληνικά::Επίπεδο Β1::Ψώνια / Шоппинг	прилавки	οι πάγκοι 
gU2Zu@mYeF	Ελληνικά::Επίπεδο Β1::Ψώνια / Шоппинг	владельцы магазинов	οι καταστηματάρχες
Q}6LfqlDve	Ελληνικά::Επίπεδο Β1::Ψώνια / Шоппинг	выборы, опции, варианты	οι επιλογές
"r#p#;W;ju5"	Ελληνικά::Επίπεδο Β1::Ψώνια / Шоппинг	вернуться к покупкам	επιστρέφω στα ψώνια 
N>Y!i<D7T	Ελληνικά::Επίπεδο Β1::Η συζήτηση, εκφράσεις / Беседа, фразы	спасибо, что сказал мне это	ευχαριστώ που μου το είπες
Ko>b]rWg08	Ελληνικά::Επίπεδο Β1::Επιπλέον / Дополнительно	ужасно	χάλια 
P]d2O|RVR>	Ελληνικά::Επίπεδο Β1::Η συζήτηση, εκφράσεις / Беседа, фразы	абсолютно	απόλυτα
"E%ID_E{3w#"	Ελληνικά::Επίπεδο Β1::Επιπλέον / Дополнительно	права / право	τα δικαιώματα / το δικαιώμα
kfNIA>mm`.	Ελληνικά::Επίπεδο Β1::Επιπλέον / Дополнительно	износ, повреждения	οι φθορές
kOx))%feEL	Ελληνικά::Επίπεδο Β1::Η συζήτηση, εκφράσεις / Беседа, фразы	как можно скорее	το συντομότερο δυνατόν
bKlYB66=Cs	Ελληνικά::Επίπεδο Β1::Επιπλέον / Дополнительно	готовность	η προθυμία
DHIK-:ic4P	Ελληνικά::Επίπεδο Β1::Επιπλέον / Дополнительно	кружка	το φλιτζάνι 
orMrE-8Ijd	Ελληνικά::Επίπεδο Β1::Παραλία / Пляж	пляж фигового дерева	η παραλία της συκιάς
m_|,gj5}|W	Ελληνικά::Επίπεδο Β1::Παραλία / Пляж	залив	ο κόλπος
"Ra#i+_+b^5"	Ελληνικά::Επίπεδο Β1::Παραλία / Пляж	дайвер	ο δύτης
ba$NFL.Rxz	Ελληνικά::Επίπεδο Β1::Παραλία / Пляж	база	η βάση
mH;p,Bxm8Y	Ελληνικά::Επίπεδο Β1::Παραλία / Пляж	течение	το ρέυμα
iYkkCr{~2N	Ελληνικά::Επίπεδο Β1::Παραλία / Пляж	направление	η κατεύθυνση
J=s>`f!vQR	Ελληνικά::Επίπεδο Β1::Παραλία / Пляж	пещера / пещеры	η σπηλιά / οι σπηλιές
nveu`M%+@?	Ελληνικά::Επίπεδο Β1::Παραλία / Пляж	маяк	ο φάρος
uhV6_0EzY,	Ελληνικά::Επίπεδο Β1::Επιπλέον / Дополнительно	в ряд (in a row)	στην σειρά 
ddX(}Ba[i~	Ελληνικά::Επίπεδο Β1::Επιπλέον / Дополнительно	в линию	στη γραμμή 
M!Cv%:,J8`	Ελληνικά::Επίπεδο Β1::Παραλία / Пляж	нудистские пляжи	οι παραλίες για γυμνιστές
F;?1Rl8<6}	Ελληνικά::Επίπεδο Β1::Η συζήτηση, εκφράσεις / Беседа, фразы	Чья очередь? Кто следующий?	Ποιός έχει σειρά;
d7x:H)$5gN	Ελληνικά::Επίπεδο Β1::Η συζήτηση, εκφράσεις / Беседа, фразы	Ты в очереди?	Είσαι στην σειρά;
uBa&Fy3y?`	Ελληνικά::Επίπεδο Β1::Επιπλέον / Дополнительно	рекомендация 	η σύσταση
D6ouN4{rN.	Ελληνικά::Επίπεδο Β1::Τα ρήματα / Глаголы	решать	αποφασίζω, αποφάσισα, θα αποφασίσω
Dr)5wLl$nl	Ελληνικά::Επίπεδο Β1::Επιπλέον / Дополнительно	специально (especially), особенно 	ειδικά 
J;<]?H}[u	Ελληνικά::Επίπεδο Β1::Το κοινωνικό δίκτυο / Социальная сеть	минусы, недостатки	τα μειονεκτήματα
F[Yba8-|]u	Ελληνικά::Επίπεδο Β1::Το κοινωνικό δίκτυο / Социальная сеть	зависимость, пристрастие (addiction)	ο εθισμός
P+N@Kld_^g	Ελληνικά::Επίπεδο Β1::Το κοινωνικό δίκτυο / Социальная сеть	зависимость	η εξάρτηση
pzTMzRXl_K	Ελληνικά::Επίπεδο Β1::Το κοινωνικό δίκτυο / Социальная сеть	подписчики	οι ακόλουθοι
bA._@UGaxJ	Ελληνικά::Επίπεδο Β1::Το κοινωνικό δίκτυο / Социальная сеть	тратить время	ξοδεύω χρόνο
ew->5U{NRT	Ελληνικά::Επίπεδο Β1::Το κοινωνικό δίκτυο / Социальная сеть	плюсы, достоинства 	τα πλεονεκτήματα
iBUHoF}cwW	Ελληνικά::Επίπεδο Β1::Το κοινωνικό δίκτυο / Социальная сеть	положительные стороны	τα θετικά 
n&I=-c@/xH	Ελληνικά::Επίπεδο Β1::Το κοινωνικό δίκτυο / Социальная сеть	отрицательные стороны	τα αρνητικά 
p<j*t@<0/Z	Ελληνικά::Επίπεδο Β1::Το κοινωνικό δίκτυο / Социальная сеть	инструмент (tool)	το εργαλείο 
k?~eJe)&%N	Ελληνικά::Επίπεδο Β1::Το κοινωνικό δίκτυο / Социальная сеть	связаться (communicate)	επικοινωνώ, επικοινώνησα, θα επικοινωνήσω 
fuCXJ?Ed4-	Ελληνικά::Επίπεδο Β1::Το κοινωνικό δίκτυο / Социальная сеть	моё существование 	η ύπαρξη μου
l[;C.:%nDN	Ελληνικά::Επίπεδο Β1::Το κοινωνικό δίκτυο / Социальная сеть	моим подписчикам	στους ακόλουθους μου
?e@:Z(&Ri	Ελληνικά::Επίπεδο Β1::Το κοινωνικό δίκτυο / Социальная сеть	реальный мир	ο αληθινός κοσμος
x;-.%koc/Z	Ελληνικά::Επίπεδο Β1::Το κοινωνικό δίκτυο / Социальная сеть	фотографировать	βγάζω φωτογραφίες 
Mir-(ZBA[s	Ελληνικά::Επίπεδο Β1::Το κοινωνικό δίκτυο / Социальная сеть	кибер-преступление	το διαδικτυακό έγκλημα
G@K5ciQjF/	Ελληνικά::Επίπεδο Β1::Το κοινωνικό δίκτυο / Социальная сеть	убийство	η δολοφονία
Ll</Lg}cf{	Ελληνικά::Επίπεδο Β1::Το κοινωνικό δίκτυο / Социальная сеть	фейковый профиль	το ψεύτικο προφίλ 
s!$f-b,T&:	Ελληνικά::Επίπεδο Β1::Το κοινωνικό δίκτυο / Социальная сеть	внимательный, бдительный	προσεκτικός 
esEFK[uS!>	Ελληνικά::Επίπεδο Β1::Το κοινωνικό δίκτυο / Социальная сеть	проверить	ελέγχω, έλεγξα, θα ελέγξω 
d}B1%+ze_(	Ελληνικά::Επίπεδο Β1::Το κοινωνικό δίκτυο / Социальная сеть	незнакомец	ο άγνωστος 
pG.HHO0,9i	Ελληνικά::Επίπεδο Β1::Τα ρήματα / Глаголы	строить	κτίζω, έκτισα, θα κτίσω
Mg8*2n(b2q	Ελληνικά::Επίπεδο Β1::Επίθετα / Прилагательные	сварливый / сварливая / сварливое	γκρινιάρης / γκρινιάρα / γκρινιάρικο
HR9(b5I.l=	Ελληνικά::Επίπεδο Β1::Επίθετα / Прилагательные	завистливый (ревнивый) / завистливая (ревнивая) / завистливое (ревнивое)	ζηλιάρης / ζηλιάρα / ζηλιάρικο
vU{I,/(P!6	Ελληνικά::Επίπεδο Β1::Επίθετα / Прилагательные	льстивый (кокетливый) / льстивая (кокетливая) / льстивое (кокетливое)	ναζιάρης / ναζιάρα / ναζιάρικο
p`1~VD`%R%	Ελληνικά::Επίπεδο Β1::Επίθετα / Прилагательные	забывчивый / забывчивая / забывчивое	ξεχασιάρης / ξεχασιάρα / ξεχασιάρικο
"m6pW##Y+nd"	Ελληνικά::Επίπεδο Β1::Επίθετα / Прилагательные	ленивый / ленивая / ленивое	τεμπέλης / τεμπέλα / τεμπέλικο
"D><Jl&98b#"	Ελληνικά::Επίπεδο Β1::Επίθετα / Прилагательные	сплетничающий / сплетничающая / сплетничающее	κουτσομπόλης / κουτσομπόλα / κουτσομπόλικο
g&eZ4[A~6/	Ελληνικά::Επίπεδο Β1::Επίθετα / Прилагательные	упрямый / упрямая / упрямое	πεισματάρης / πεισματάρα / πεισματάρικο
b=/RYw9EhE	Ελληνικά::Επίπεδο Β1::Επίθετα / Прилагательные	жалующийся / жалующаяся / жалующееся	παραπονιάρης / παραπονιάρα / παραπονιάρικο
qzu0<ZQ`8L	Ελληνικά::Επίπεδο Β1::Επίθετα / Прилагательные	скупой / скупая / скупое	τσιγκούνης / τσιγκούνα / τσιγκούνικο
"O^^L9U~*$#"	Ελληνικά::Επίπεδο Β1::Επίθετα / Прилагательные	трусливый / трусливая / трусливое	φοβητσιάρης / φοβητσιάρα / φοβητσιάρικο
utj3$IGpKy	Ελληνικά::Επίπεδο Β1::Επίθετα / Прилагательные	игривый / игривая / игривое	παιχνιδιάρης / παιχνιδιάρα / παιχνιδιάρικο
i`?7%7Hz45	Ελληνικά::Επίπεδο Β1::Επίθετα / Прилагательные	пятидесятилетний / пятидесятилетняя / пятидесятилетнее	πενηντάρης / πενηντάρα / πενηντάρικο
fY$sHS[Y=u	Ελληνικά::Επίπεδο Β1::Επίθετα / Прилагательные	рыжеволосый / рыжеволосая / рыжеволосое	κοκκινομάλλης / κοκκινομάλλα / κοκκινομάλλικο
p3F^~!Gkyy	Ελληνικά::Επίπεδο Β1::Επίθετα / Прилагательные	голубоглазый / голубоглазая / голубоглазое	γαλανομάτης / γαλανομάτα / γαλανομάτικο
f27Y%ix9:^	Ελληνικά::Επίπεδο Β1::Επίθετα / Прилагательные	малюсенький / малюсенькая / малюсенькое	μικρούλης / μικρούλα / μικρούλικο (μικρούλι)
Q:!Nf/D1C=	Ελληνικά::Επίπεδο Β1::Μέσα μαζικής μεταφοράς / Общественный транспорт	маршрут, путь	η διαδρομή 
rf3]OR*;,~	Ελληνικά::Επίπεδο Β1::Μέσα μαζικής μεταφοράς / Общественный транспорт	транспортное сообщение	οι συγκοινωνίες 
b:T&e4,7=I	Ελληνικά::Επίπεδο Β1::Μέσα μαζικής μεταφοράς / Общественный транспорт	мне удобно, мне подходит	με βολεύει
k?g=E<Bok>	Ελληνικά::Επίπεδο Β1::Μέσα μαζικής μεταφοράς / Общественный транспорт	мегаполисы	οι μεγαλοπόλεις
mcP.A=!Xkw	Ελληνικά::Επίπεδο Β1::Μέσα μαζικής μεταφοράς / Общественный транспорт	проблема с дорожным движением, транспортная проблема	το κυκλοφοριακό πρόβλημα 
;n&Bc_>xG	Ελληνικά::Επίπεδο Β1::Μέσα μαζικής μεταφοράς / Общественный транспорт	жители	οι κάτοικοι
mAIr?JUs$U	Ελληνικά::Επίπεδο Β1::Μέσα μαζικής μεταφοράς / Общественный транспорт	скорость	η ταχύτητα 
Csxma2TqDp	Ελληνικά::Επίπεδο Β1::Μέσα μαζικής μεταφοράς / Общественный транспорт	плата за проезд, дорожный сбор	τα διόδια
n|lq(H]P/]	Ελληνικά::Επίπεδο Β1::Μέσα μαζικής μεταφοράς / Общественный транспорт	пробиваю билет	επικυρώνω εισιτήριο 
MF0jTVf6OY	Ελληνικά::Επίπεδο Β1::Ψώνια / Шоппинг	квитанция, чек	η απόδειξη 
fr`{.DVU:*	Ελληνικά::Επίπεδο Β1::Ψώνια / Шоппинг	рассрочка	η δόση
f1A,[Svn?y	Ελληνικά::Επίπεδο Β1::Ψώνια / Шоппинг	очень дешёвые	πάμφθηνα
bV!/*HV=_0	Ελληνικά::Επίπεδο Β1::Ψώνια / Шоппинг	очень дорогие	πανάκριβα
KfDM8lHc@o	Ελληνικά::Επίπεδο Β1::Ψώνια / Шоппинг	в клетку	το καρό
hhfT?*%zdf	Ελληνικά::Επίπεδο Β1::Ψώνια / Шоппинг	в горошек	με βούλες / με πουά
e7rpq}u5VC	Ελληνικά::Επίπεδο Β1::Ψώνια / Шоппинг	одноцветный, однотонный	μονόχρωμος
p9UbIvR-04	Ελληνικά::Επίπεδο Β1::Ψώνια / Шоппинг	в полоску	ριγέ
pz7{6e;H8W	Ελληνικά::Επίπεδο Β1::Ψώνια / Шоппинг	в моде	είναι της μόδας 
O.Y2SC:e5e	Ελληνικά::Επίπεδο Β1::Ψώνια / Шоппинг	летняя / зимняя одежда	τα καλοκαιρινά / χειμερινά ρούχα 
"Bi<4H#wozR"	Ελληνικά::Επίπεδο Β1::Ψώνια / Шоппинг	классическая одежда 	τα κλασικά ρούχα 
L>$xwvuH~5	Ελληνικά::Επίπεδο Β1::Ψώνια / Шоппинг	вечерняя одежда	τα βραδινά ρούχα 
cl$B0V,Pt<	Ελληνικά::Επίπεδο Β1::Ψώνια / Шоппинг	брендовые	επώνυμα
FB86&j!$A+	Ελληνικά::Επίπεδο Β1::Ψώνια / Шоппинг	элегантные	κομψά
tFR8.jb,~Z	Ελληνικά::Επίπεδο Β1::Ψώνια / Шоппинг	шерстяное	μάλλινο
Lp{y9:pLh/	Ελληνικά::Επίπεδο Β1::Ψώνια / Шоппинг	шёлковое	μεταξωτό
zAYAU?yc6S	Ελληνικά::Επίπεδο Β1::Ψώνια / Шоппинг	кожаное	δερμάτινο
Q27fELY>fe	Ελληνικά::Επίπεδο Β1::Ψώνια / Шоппинг	меховое	γούνινο
K,M0?ELP}p	Ελληνικά::Επίπεδο Β1::Ψώνια / Шоппинг	пуговицы, кнопки	τα κουμπιά
m|hSX$qvCs	Ελληνικά::Επίπεδο Β1::Ψώνια / Шоппинг	иглы	οι βελόνες
HAXniJ,dV4	Ελληνικά::Επίπεδο Β1::Ψώνια / Шоппинг	ножницы	το ψαλίδι
CjC/)iSPkk	Ελληνικά::Επίπεδο Β1::Ψώνια / Шоппинг	молния (застёжка)	το φερμουάρ
`;ktR(V]f	Ελληνικά::Επίπεδο Β1::Ψώνια / Шоппинг	кружево	η δαντέλα
h^{f}DJ/lp	Ελληνικά::Επίπεδο Β1::Ψώνια / Шоппинг	покупки	τα ψώνια
"rrE)Yoe+#E"	Ελληνικά::Επίπεδο Β1::Επίθετα / Прилагательные	широкий / широкая / широкое	φαρδύς / φαρδιά / φαρδύ
qKY9I:Y+fV	Ελληνικά::Επίπεδο Β1::Επίθετα / Прилагательные	толстый / толстая / толстое	παχύς / παχιά / παχύ
x[urPy1O07	Ελληνικά::Επίπεδο Β1::Επίθετα / Прилагательные	глубокий / глубокая / глубокое	βαθύς / βαθιά / βαθύ
sdnPm}He,/	Ελληνικά::Επίπεδο Β1::Επίθετα / Прилагательные	длинный / длинная / длинное	μακρύς / μακριά / μακρύ
cM,K5j0mHL	Ελληνικά::Επίπεδο Β1::Επίθετα / Прилагательные	коричневый / коричневая / коричневое	καφετής / καφετιά / καφετί
GIp:*1tZZ	Ελληνικά::Επίπεδο Β1::Επίθετα / Прилагательные	вишнёвый / вишнёвая / вишнёвое	βυσσινής / βυσσινιά / βυσσινί
b(gky]1lhI	Ελληνικά::Επίπεδο Β1::Επίθετα / Прилагательные	морской / морская / морское, цвет морской волны	θάλασσής / θαλασσιά / θαλασσί
C9YLv8+4%c	Ελληνικά::Επίπεδο Β1::Επίθετα / Прилагательные	коричный / коричная / коричное (цвет корицы)	κανελής / κανελιά / κανελί
x<>0oULmAj	Ελληνικά::Επίπεδο Β1::Επίθετα / Прилагательные	шоколадный / шоколадная / шоколадное	σοκολατής / σοκολατιά / σοκολατί
GPa[s_HA5T	Ελληνικά::Επίπεδο Β1::Επίθετα / Прилагательные	пепельный / пепельная / пепельное	σταχτής / σταχτιά / σταχτί
A@MFlzr2oA	Ελληνικά::Επίπεδο Β1::Επίθετα / Прилагательные	золотистый / золотистая / золотистое	χρυσαφής / χρυσαφιά / χρυσαφί
s:$X/&>9<2	Ελληνικά::Επίπεδο Β1::Επίθετα / Прилагательные	скромный / скромная / скромное	σεμνός / σεμνή / σεμνό
D80_[=O6WT	Ελληνικά::Επίπεδο Β1::Επίθετα / Прилагательные	чувствительный / чувствительная / чувствительное	ευαίσθητος / ευαίσθητη / ευαίσθητο
"ea&YTA#,,-"	Ελληνικά::Επίπεδο Β1::Επίθετα / Прилагательные	вежливый, добрый / вежливая, добрая / вежливое, доброе	ευγενικός / ευγενική / ευγενικό
"r!#Ruw7uxI"	Ελληνικά::Επίπεδο Β1::Επίθετα / Прилагательные	энергичный / энергичная / энергичное	δυναμικός / δυναμική / δυναμικό
n/qSP)<tq(	Ελληνικά::Επίπεδο Β1::Επίθετα / Прилагательные	нервный, раздражительный / нервная, раздражительная / нервное, раздражительное	νευρικός / νευρική / νευρικό
lXCi7_|,/s	Ελληνικά::Επίπεδο Β1::Επίθετα / Прилагательные	серьёзный / серьёзная / серьёзное	σοβαρός / σοβαρή / σοβαρό 
J-+&;JeSP>	Ελληνικά::Επίπεδο Β1::Επίθετα / Прилагательные	стабильный / стабильная / стабильное	σταθερός / σταθερή / σταθερό
G?gE|Aaq4[	Ελληνικά::Επίπεδο Β1::Επίθετα / Прилагательные	умный / умная / умное	έξυπνος / έξηπνη / έξηπνο
B.uB@saBZw	Ελληνικά::Επίπεδο Β1::Επίθετα / Прилагательные	крупного телосложения	μεγαλόσωμος / μεγαλόσωμη / μεγαλόσωμο
r)}I^DpvY&	Ελληνικά::Επίπεδο Β1::Επίθετα / Прилагательные	маленького телосложения	μικρόσωμος / μικρόσωμη / μικρόσωμο
o=w*/Y%!X]	Ελληνικά::Επίπεδο Β1::Επίθετα / Прилагательные	богатый / богатая / богатое	πλούσιος / πλούσια / πλούσιο 
rQB[rYy[H>	Ελληνικά::Επίπεδο Β1::Επίθετα / Прилагательные	бедный	φτωχός / φτωχή / φτωχό
fDD~99T/L`	Ελληνικά::Επίπεδο Β1::Επίθετα / Прилагательные	оптимистичный / оптимистичная / оптимистичное	αισιόδοξος / αισιόδοξη / αισιόδοξο
EPVM9}IuWD	Ελληνικά::Επίπεδο Β1::Επίθετα / Прилагательные	приятный, симпатичный / приятная, симпатичная / приятное, симпатичное	συμπαθητικός / συμπαθητική / συμπαθητικό
oVz/5URLG3	Ελληνικά::Επίπεδο Β1::Επίθετα / Прилагательные	безответственный / безответственная / безответственное	ανεύθυνος / ανεύθυνη / ανεύθυνο
e;{^H+]s)f	Ελληνικά::Επίπεδο Β1::Επίθετα / Прилагательные	холодный, бесчувственный / холодная, бесчувственная / холодное, бесчувственное	ψυχρός / ψυχρή / ψυχρό
NN/I0~azOC	Ελληνικά::Επίπεδο Β1::Επίθετα / Прилагательные	готовый помочь / готовая помочь / готовое помочь	πρόθυμος / πρόθυμη / πρόθυμο
lE1b{*GMIW	Ελληνικά::Επίπεδο Β1::Επίθετα / Прилагательные	дружелюбный / дружелюбная / дружелюбное	φιλικός / φιλική / φιλικό
ufyN+o3:76	Ελληνικά::Επίπεδο Β1::Επίθετα / Прилагательные	кислый, недовольный / кислая, недовольная / кислое, недовольное	ξινός / ξινή / ξινό
k&]]lEG0LA	Ελληνικά::Επίπεδο Β1::Επίθετα / Прилагательные	неприятный / неприятная / неприятное	αντιπαθητικός / αντιπαθητική / αντιπαθητικό
bixYg;A!41	Ελληνικά::Επίπεδο Β1::Επίθετα / Прилагательные	враждебный / враждебная / враждебное	εχθρικός / εχθρική / εχθρικό
biUR~2gR;z	Ελληνικά::Επίπεδο Β1::Επίθετα / Прилагательные	грустный / грустная / грустное	λυπημένος / λυπημένη / λυπημένο
wad4(.WNMa	Ελληνικά::Επίπεδο Β1::Επίθετα / Прилагательные	несовершеннолетний / несовершеннолетняя / несовершеннолетнее	ανήλικος / ανήλικη / ανήλικο
"y#/B$~3?n&"	Ελληνικά::Επίπεδο Β1::Επίθετα / Прилагательные	взрослый / взрослая / взрослое	ενήλικος / ενήλικη / ενήλικο
H-H,v_dLK?	Ελληνικά::Επίπεδο Β1::Επίθετα / Прилагательные	живописный / живописная / живописное	γραφικός / γραφική / γραφικό
N<bOO.N`9M	Ελληνικά::Επίπεδο Β1::Επίθετα / Прилагательные	сказочный, как из сна / сказочная / сказочное	ονειρεμένος / ονειρεμένη / ονειρεμένο
wp3nK<LPd_	Ελληνικά::Επίπεδο Β1::Επίθετα / Прилагательные	экзотический / экзотическая / экзотическое	εξωτικός / εξωτική / εξωτικό
LRP0`*6Zr!	Ελληνικά::Επίπεδο Β1::Η συζήτηση, εκφράσεις / Беседа, фразы	ужасно дорого (пламя и лава)	φωτιά και λάβρα
DSYq)p}IH.	Ελληνικά::Επίπεδο Β1::Η συζήτηση, εκφράσεις / Беседа, фразы	спешу успеть	τρέχω να προλάβω
m7:!up{_>^	Ελληνικά::Επίπεδο Β1::Η συζήτηση, εκφράσεις / Беседа, фразы	Как дела у этого человека? (разг.)	Τι κάνει αυτή η ψυχή;
"eoPDMUhl#<"	Ελληνικά::Επίπεδο Β1::Η συζήτηση, εκφράσεις / Беседа, фразы	бесплатно / зря	τσάμπα
pfl8t|vR`X	Ελληνικά::Επίπεδο Β1::Η συζήτηση, εκφράσεις / Беседа, фразы	Через что мы прошли - не передать словами	Το τι τραβήξαμε δεν λεγέται
QI_,35~aac	Ελληνικά::Επίπεδο Β1::Η συζήτηση, εκφράσεις / Беседа, фразы	бледнею (от страха, ужаса)	χάνω το χρώμα μου
MPhoiO2|h+	Ελληνικά::Επίπεδο Β1::Η συζήτηση, εκφράσεις / Беседа, фразы	творится хаос, творится что-то невероятное 	γίνεται χαμός
COjE=~]he*	Ελληνικά::Επίπεδο Β1::Σπίτι, φύση / Дом, природа	владелец	ο ιδιοκτήτης
y?D&|Ft8C/	Ελληνικά::Επίπεδο Β1::Σπίτι, φύση / Дом, природа	арендатор 	ο ενοικιαστής
jKmNDUd0.!	Ελληνικά::Επίπεδο Β1::Σπίτι, φύση / Дом, природа	коммунальные платежи 	τα κοινόχρηστα
b|xfGE/54*	Ελληνικά::Επίπεδο Β1::Σπίτι, φύση / Дом, природа	гарантия / залог 	η εγγύηση 
e!|f^~(QA7	Ελληνικά::Επίπεδο Β1::Σπίτι, φύση / Дом, природа	поведение 	η συμπεριφορά 
yib_W{B5gj	Ελληνικά::Επίπεδο Β1::Σπίτι, φύση / Дом, природа	водонагреватель 	ο θερμοσίφωνας
1}E>7[lZR	Ελληνικά::Επίπεδο Β1::Σπίτι, φύση / Дом, природа	экономию (например, деньги)	κάνω οικονομία
r:,&th3SKv	Ελληνικά::Επίπεδο Β1::Σπίτι, φύση / Дом, природа	темнота	το σκοτάδι 
Iq91b:M.L&	Ελληνικά::Επίπεδο Β1::Σπίτι, φύση / Дом, природа	ответственный поступок 	η πράξη ευθύνης
H=p4sJj-Yz	Ελληνικά::Επίπεδο Β1::Σπίτι, φύση / Дом, природа	защищаю окружающую среду	προστατεύω το περιβάλλον
xC6@~J@tes	Ελληνικά::Επίπεδο Β1::Σπίτι, φύση / Дом, природа	улучшаю качество жизни	βελτιώνω την ποιότητα ζωής
CflzK4z(];	Ελληνικά::Επίπεδο Β1::Σπίτι, φύση / Дом, природа	экономию энергию	κάνω εξοικονόμηση ενέργειας
MSiWqMeS3^	Ελληνικά::Επίπεδο Β1::Σπίτι, φύση / Дом, природа	лучшее будущее	το καλύτερο μέλλον 
Jpcsu!@U`6	Ελληνικά::Επίπεδο Β1::Σπίτι, φύση / Дом, природа	поддерживаю программу	στηρίζω το πρόγραμμα 
qd0{PI[a)^	Ελληνικά::Επίπεδο Β1::Σπίτι, φύση / Дом, природа	стоит того	αξίζει τον κόπο
xmDw;iVL-0	Ελληνικά::Επίπεδο Β1::Σπίτι, φύση / Дом, природа	необходимо информирование 	χρειάζεται ενημέρωση
qk<iPJkx/V	Ελληνικά::Επίπεδο Β1::Σπίτι, φύση / Дом, природа	наличие контейнеров для мусора	η παρουσία κάδων
Q_9bQ$%Ua4	Ελληνικά::Επίπεδο Β1::Σπίτι, φύση / Дом, природа	тип упаковки (бумага, железо, стекло, алюминий, пластик)	ο τύπος συσκευασίας (χαρτί, σίδερο, γυαλί, αλουμίνιο, πλαστικό)
"qOF#.q`Y~]"	Ελληνικά::Επίπεδο Β1::Σπίτι, φύση / Дом, природа	повреждение / поломка	η βλάβη
l!y$i9m?k~	Ελληνικά::Επίπεδο Β1::Σπίτι, φύση / Дом, природа	утечка	η διαρροή
m?_:DZaD73	Ελληνικά::Επίπεδο Β1::Σπίτι, φύση / Дом, природа	потребление воды	η κατανάλωση νερού 
"O+fV#AhEQG"	Ελληνικά::Επίπεδο Β1::Σπίτι, φύση / Дом, природа	счётчик	ο μετρητής
HEC|2B{o=h	Ελληνικά::Επίπεδο Β1::Σπίτι, φύση / Дом, природа	главный в компании 	ο γενικός της εταιρείας
oL/z=B]Hdu	Ελληνικά::Επίπεδο Β1::Σπίτι, φύση / Дом, природа	завышенный, раздутый счёт	ο φουσκωμένος λογαριασμός 
"l#Eh:goIU0"	Ελληνικά::Επίπεδο Β1::Σπίτι, φύση / Дом, природа	строю / построил / построю	χτίζω / έχτησα / θα χτήσω
w*Jo4$3:<+	Ελληνικά::Επίπεδο Β1::Σπίτι, φύση / Дом, природа	строительство 	η κατασκευή
G<_l=Vz[bm	Ελληνικά::Επίπεδο Β1::Σπίτι, φύση / Дом, природа	жильё	η κατοικία
rE>U~6rG5J	Ελληνικά::Επίπεδο Β1::Σπίτι, φύση / Дом, природа	дерево (материал)	το ξύλο 
g~]HMV:cjt	Ελληνικά::Επίπεδο Β1::Σπίτι, φύση / Дом, природа	солома	το άχυρο
FQ)xzVO`BZ	Ελληνικά::Επίπεδο Β1::Σπίτι, φύση / Дом, природа	безопасность 	η ασφάλεια 
yU2ZfB^Fc`	Ελληνικά::Επίπεδο Β1::Σπίτι, φύση / Дом, природа	колонна	η κολόνα
B!x]O;xl`E	Ελληνικά::Επίπεδο Β1::Σπίτι, φύση / Дом, природа	продажа	η πώληση
L^*PeP*/O+	Ελληνικά::Επίπεδο Β1::Σπίτι, φύση / Дом, природа	покупка	η αγορά
xiNd<7Hk<H	Ελληνικά::Επίπεδο Β1::Σπίτι, φύση / Дом, природа	аренда 	η ενοικίαση
QvZH&MKRKI	Ελληνικά::Επίπεδο Β1::Σπίτι, φύση / Дом, природа	почва / грунт	το έδαφος
cz*.w@_pe&	Ελληνικά::Επίπεδο Β1::Σπίτι, φύση / Дом, природа	стоимость 	το κόστος
qsFX0<lyk6	Ελληνικά::Επίπεδο Β1::Σπίτι, φύση / Дом, природа	ремонт / обновление 	η ανακαίνιση
I=jNxlmKav	Ελληνικά::Επίπεδο Β1::Σπίτι, φύση / Дом, природа	декор / украшение	η διακόσμηση
g2zH8LQJ|A	Ελληνικά::Επίπεδο Β1::Σπίτι, φύση / Дом, природа	чистота	η καθαριότητα 
y18f@_0e&D	Ελληνικά::Επίπεδο Β1::Σπίτι, φύση / Дом, природа	образ жизни	ο τρόπος ζωής 
s]u~4|WWO~	Ελληνικά::Επίπεδο Β1::Σπίτι, φύση / Дом, природа	свалка 	η χωματερή
gsL|]P(1)Z	Ελληνικά::Επίπεδο Β1::Σπίτι, φύση / Дом, природа	остатки еды	τα αποφάγια
GJ0[cBO4+d	Ελληνικά::Επίπεδο Β1::Σπίτι, φύση / Дом, природа	батарейка 	η μπαταρία
xvn;[sr0J6	Ελληνικά::Επίπεδο Β1::Σπίτι, φύση / Дом, природа	промышленный район	η βιομηχανική περιοχή 
Jefj,ncb50	Ελληνικά::Επίπεδο Β1::Σπίτι, φύση / Дом, природа	заводы	τα εργοστάσια 
H]O?a^>i=[	Ελληνικά::Επίπεδο Β1::Σπίτι, φύση / Дом, природа	упаковка 	η συσκευασία
Pde-yKGWiB	Ελληνικά::Επίπεδο Β1::Σπίτι, φύση / Дом, природа	выращивание (растений)	η καλλιέργεια 
BD^:kzbp{V	Ελληνικά::Επίπεδο Β1::Σπίτι, φύση / Дом, природа	сажаю / посадил / посажу	φυτεύω / φύτεψα / θα φυτέψω
O@,kob&N*h	Ελληνικά::Επίπεδο Β1::Σπίτι, φύση / Дом, природа	загрязнение 	η μόλυνση
t:XUKQS<+3	Ελληνικά::Επίπεδο Β1::Σπίτι, φύση / Дом, природа	мусор	τα σκουπίδια
"y:ad:Ug#&$"	Ελληνικά::Επίπεδο Β1::Σπίτι, φύση / Дом, природа	шумовое загрязнение 	η ηχορύπανση
QR;RrV95yp	Ελληνικά::Επίπεδο Β1::Το φαγητό / Еда	фастфуд	το γρήγορο φαγητό 
"h#]hcmy%?,"	Ελληνικά::Επίπεδο Β1::Το φαγητό / Еда	отказываюсь от сладкого 	κόβω τα γλυκά 
rD;x&]Qxjg	Ελληνικά::Επίπεδο Β1::Το φαγητό / Еда	закусочная с узо	το ουζερί
"GMv%l#`)5D"	Ελληνικά::Επίπεδο Β1::Το φαγητό / Еда	шашлычная	το σουβλιτζίδικο 
n$M;,Akle7	Ελληνικά::Επίπεδο Β1::Το φαγητό / Еда	фастфуд-заведение	το φαστφουτάδικο
N8})EaRv[	Ελληνικά::Επίπεδο Β1::Το φαγητό / Еда	сковорода	το τηγάνι
sw48t2,F/}	Ελληνικά::Επίπεδο Β1::Το φαγητό / Еда	тёрка	ο τρίφτης
I@|<KM^`1&	Ελληνικά::Επίπεδο Β1::Το φαγητό / Еда	бутербродница	η τοστιέρα
"MAAnsF>#iP"	Ελληνικά::Επίπεδο Β1::Το φαγητό / Еда	кофеварка	η καφετιέρα
ob1olh^4]@	Ελληνικά::Επίπεδο Β1::Το φαγητό / Еда	на углях	στα κάρβουνα
eqr/Q,V)EL	Ελληνικά::Επίπεδο Β1::Το φαγητό / Еда	на решётке	στη σχάρα
"LWWQv#cbS8"	Ελληνικά::Επίπεδο Β1::Το φαγητό / Еда	на гриле, на барбекю 	στην ψησταριά
HEP1*8p1t!	Ελληνικά::Επίπεδο Β1::Το φαγητό / Еда	противень	το ταψί
y>Rg}$2T>x	Ελληνικά::Επίπεδο Β1::Το φαγητό / Еда	солонка	η αλατιέρα
nc;PuJ^fr[	Ελληνικά::Επίπεδο Β1::Το φαγητό / Еда	столовые приборы	τα μαχαιροπίρουνα
EK5980j{)8	Ελληνικά::Επίπεδο Β1::Το φαγητό / Еда	ингредиенты 	τα υλικά
P}M5**v(O;	Ελληνικά::Επίπεδο Β1::Το φαγητό / Еда	мелко нарезаю / мелко нарезал / мелко нарежу	ψιλοκόβω / ψιλόκοψα / θα ψιλοκόψω
"vx#aSHK39A"	Ελληνικά::Επίπεδο Β1::Το φαγητό / Еда	разогреваю / разогрел / разогрею	ζεσταίνω / ζέστανα / θα ζεστάνω
G3h*U0MW]g	Ελληνικά::Επίπεδο Β1::Το φαγητό / Еда	содержание	το περιεχόμενο
d&rxE64s/t	Ελληνικά::Επίπεδο Β1::Το φαγητό / Еда	пищевые привычки	οι διατροφικές συνήθειες
dgoAG}QAkn	Ελληνικά::Επίπεδο Β1::Το φαγητό / Еда	слабости	οι αδυναμίες
b;J11myhh$	Ελληνικά::Επίπεδο Β1::Το φαγητό / Еда	вкусовые предпочтения	οι γευστικές προτιμήσεις
p%yHjo.j9&	Ελληνικά::Επίπεδο Β1::Το φαγητό / Еда	белки	οι πρωτεΐνες
ruwY!Zn.`0	Ελληνικά::Επίπεδο Β1::Το φαγητό / Еда	витамины	οι βιταμίνες 
nYcymmXt3R	Ελληνικά::Επίπεδο Β1::Το φαγητό / Еда	углеводы 	οι υδατάνθρακες
p72i@vxxKG	Ελληνικά::Επίπεδο Β1::Το φαγητό / Еда	замороженные продукты 	τα κατεψυγμένα
jU|GeV;tR2	Ελληνικά::Επίπεδο Β1::Το φαγητό / Еда	выжимаю апельсиновый сок	στίβω πορτοκαλάδα
cSH4`3-lhh	Ελληνικά::Επίπεδο Β1::Το φαγητό / Еда	органические продукты 	τα βιολογικά προϊόντα 
eCK;7L*3X<	Ελληνικά::Επίπεδο Β1::Το φαγητό / Еда	средиземноморская диета	η μεσογειακή διατροφή 
w>Gk{k0Y_?	Ελληνικά::Επίπεδο Β1::Το φαγητό / Еда	вкусный	νόστιμο
jVhN]fTun4	Ελληνικά::Επίπεδο Β1::Το φαγητό / Еда	аппетитный, вкусный	γευστικό
fI+>N~jjAV	Ελληνικά::Επίπεδο Β1::Το φαγητό / Еда	диетический	διαιτητικό
w^AI~oR0<]	Ελληνικά::Επίπεδο Β1::Το φαγητό / Еда	полезно для здоровья 	υγιεινό
yY;[=7kvMd	Ελληνικά::Επίπεδο Β1::Το φαγητό / Еда	нут	τα ρεβύθια
B;5SS$!hWC	Ελληνικά::Επίπεδο Β1::Το φαγητό / Еда	горечь / неприятности	οι πίκρες
z;!m0ly8wW	Ελληνικά::Επίπεδο Β1::Το φαγητό / Еда	орехи, семечки	οι ξηροί καρποί
h8=ZJ6nq3^	Ελληνικά::Επίπεδο Β1::Το φαγητό / Еда	специи	τα μπαχαρικά
lv&WJU/bwD	Ελληνικά::Επίπεδο Β1::Το φαγητό / Еда	тесто	η ζύμη
p{5`lN+Nz!	Ελληνικά::Επίπεδο Β1::Το φαγητό / Еда	закуски	τα ορεκτικά
Kf7Y|p[NV3	Ελληνικά::Επίπεδο Β1::Το φαγητό / Еда	основные блюда	τα κυρίως πιάτα
"tjh+V1#yIP"	Ελληνικά::Επίπεδο Β1::Το φαγητό / Еда	орегано	η ρίγανη
eK!P5[3~y(	Ελληνικά::Επίπεδο Β1::Το φαγητό / Еда	лавровый лист	η δάφνη
"CCb_cb#(jD"	Ελληνικά::Επίπεδο Β1::Το φαγητό / Еда	гвоздика	το γαρύφαλλο
uZE.+<zQ`2	Ελληνικά::Επίπεδο Β1::Το φαγητό / Еда	мята 	ο δυόσμος
c-9sOaw%g~	Ελληνικά::Επίπεδο Β1::Το φαγητό / Еда	корица	η κανέλα
KQA{Y$FlC}	Ελληνικά::Επίπεδο Β1::Το φαγητό / Еда	завтрак	το πρωινό 
o7GtO76&,8	Ελληνικά::Επίπεδο Β1::Το φαγητό / Еда	второй завтрак 	το δεκατιανό
pmNAGh$;h;	Ελληνικά::Επίπεδο Β1::Το φαγητό / Еда	обед	το μεσημεριανό 
g}bT|pV{(8	Ελληνικά::Επίπεδο Β1::Το φαγητό / Еда	полдник / дневной перекус	το απογευματινό
Ez0fm_VmVF	Ελληνικά::Επίπεδο Β1::Το φαγητό / Еда	ужин	το βραδινό
ByWi-zEeR|	Ελληνικά::Επίπεδο Β1::Καιρός / Погода	прохлада	η ψύχρα
i8gqdRfZo4	Ελληνικά::Επίπεδο Β1::Καιρός / Погода	освежающая прохлада 	η δροσιά
K(XvVdOJ`j	Ελληνικά::Επίπεδο Β1::Καιρός / Погода	сильный мороз	η παγωνιά
QOe/z$cYYY	Ελληνικά::Επίπεδο Β1::Καιρός / Погода	ненастье	η κακοκαιρία
qa8W;U?@}(	Ελληνικά::Επίπεδο Β1::Καιρός / Погода	плохая погода	ο παλιόκαιρος
quST@ob[b>	Ελληνικά::Επίπεδο Β1::Καιρός / Погода	мягкая, умеренная погода	ο ήπιος καιρός 
rdcuh.J+&l	Ελληνικά::Επίπεδο Β1::Καιρός / Погода	дождливый	βροχερός
"gl*SZbJ#@U"	Ελληνικά::Επίπεδο Β1::Καιρός / Погода	солнечная погода	η λιακάδα
Bj_9$t<q{P	Ελληνικά::Επίπεδο Β1::Καιρός / Погода	мокрый снег	το χιονόνερο
xVz/vliz%!	Ελληνικά::Επίπεδο Β1::Καιρός / Погода	моросит	ψιχαλίζει, ψιχάλισε, θα ψιχαλίσει
w$,f7];8f[	Ελληνικά::Επίπεδο Β1::Καιρός / Погода	идёт мелкий дождь	ψιλοβρέχει, ψιλοέβρεξε, θα ψιλοβρέξει
b~cHj=p~X;	Ελληνικά::Επίπεδο Β1::Καιρός / Погода	гром	οι βροντές
y5iLCwnC5:	Ελληνικά::Επίπεδο Β1::Καιρός / Погода	солнечность	η ηλιοφάνεια
Oy><:+m9^_	Ελληνικά::Επίπεδο Β1::Καιρός / Погода	облачность	οι νεφώσεις
tn]Hnd:ud6	Ελληνικά::Επίπεδο Β1::Καιρός / Погода	северные ветры	οι βοριάδες
DNtTi41c@G	Ελληνικά::Επίπεδο Β1::Καιρός / Погода	южные ветры	οι νοτιάδες
j-?f!2*cy,	Ελληνικά::Επίπεδο Β1::Καιρός / Погода	восточный / западный ветер	ο ανατολικός / δυτικός άνεμος
"EMSUtU#dX|"	Ελληνικά::Επίπεδο Β1::Καιρός / Погода	повышение / понижение температуры 	η άνοδος / πτώση θερμοκρασίας
paD/si7W+0	Ελληνικά::Επίπεδο Β1::Καιρός / Погода	метеоролог	ο/η μετεορολόγος
tC~;8=,FU_	Ελληνικά::Επίπεδο Β1::Καιρός / Погода	ледник	ο παγετώνας
D=aP8S@F&~	Ελληνικά::Επίπεδο Β1::Καιρός / Погода	тайфун	ο τυφώνας
f60K(Uz@Eq	Ελληνικά::Επίπεδο Β1::Καιρός / Погода	смерч	ο ανεμοστρόβιλος
fpoF7SQYH<	Ελληνικά::Επίπεδο Β1::Καιρός / Погода	пожар	η πυρκαγιά
"i#_=YZuHB."	Ελληνικά::Επίπεδο Β1::Καιρός / Погода	землетрясение 	ο σεισμός
Oe~m2VCD,{	Ελληνικά::Επίπεδο Β1::Καιρός / Погода	наводнение 	η πλυμμύρα
i8@Wl;=B3l	Ελληνικά::Επίπεδο Β1::Καιρός / Погода	вулкан	το ηφαίστειο
DQvp[I5y,`	Ελληνικά::Επίπεδο Β1::Καιρός / Погода	река	το ποτάμι
j*/>nZc:M2	Ελληνικά::Επίπεδο Β1::Καιρός / Погода	северный / южный полюс	ο βόρειος / νότιος πόλος
h.KnpxTp/^	Ελληνικά::Επίπεδο Β1::Καιρός / Погода	пустыня 	η έρημος
H(p*B3[@BM	Ελληνικά::Επίπεδο Β1::Καιρός / Погода	океан	ο ωκεανός
"kzLoczbHQ#"	Ελληνικά::Επίπεδο Β1::Καιρός / Погода	каньон	το φαράγγι
F;$)wC:r;g	Ελληνικά::Επίπεδο Β1::Καιρός / Погода	планеты	οι πλανήτες 
kO6%B1dI6;	Ελληνικά::Επίπεδο Β1::Υπηρεσίες / Услуги, государственные службы	министерство	το υπουργείο
kJ9!QDxdec	Ελληνικά::Επίπεδο Β1::Υπηρεσίες / Услуги, государственные службы	муниципалитет, городская администрация	ο δήμος
i.QuiR:ox/	Ελληνικά::Επίπεδο Β1::Υπηρεσίες / Услуги, государственные службы	регион / округ	η περιφέρεια
y_9gMVq.wq	Ελληνικά::Επίπεδο Β1::Υπηρεσίες / Услуги, государственные службы	центр обслуживания граждан	το κέντρο εξυπηρέτησης πολίτη, το ΚΕΠ
AgV8`Iz!Lv	Ελληνικά::Επίπεδο Β1::Υπηρεσίες / Услуги, государственные службы	организация занятости трудовых ресурсов	ο οργανισμός απασχόλησης εργατικού δυναμικού, ο ΟΑΕΔ
y!L|~@Q{^,	Ελληνικά::Επίπεδο Β1::Υπηρεσίες / Услуги, государственные службы	фонд социального страхования	το ίδρυμα κοινωνικών ασφαλίσεων, ΕΦΚΑ
C7`5,_Byrx	Ελληνικά::Επίπεδο Β1::Υπηρεσίες / Услуги, государственные службы	налоговая	η εφορία
w.E?;@~?jH	Ελληνικά::Επίπεδο Β1::Υπηρεσίες / Услуги, государственные службы	полиция	η αστυνομία
"bvG|@M|#O%"	Ελληνικά::Επίπεδο Β1::Υπηρεσίες / Услуги, государственные службы	пожарная служба	η πυροσβεστική
zt_H`RERi^	Ελληνικά::Επίπεδο Β1::Υπηρεσίες / Услуги, государственные службы	портовая служба / береговая охрана	το λιμενικό
"E&Y)dn#<x`"	Ελληνικά::Επίπεδο Β1::Υπηρεσίες / Услуги, государственные службы	государственные предприятия и организации	οι δημόσιες επιχειρήσεις και οργανισμοί
tjdw=9>cP2	Ελληνικά::Επίπεδο Β1::Υπηρεσίες / Услуги, государственные службы	государственная электрокомпания	η δημόσια επιχείρηση ηλεκτρικού ρεύματος, η ΔΕΗ
MusvzDX;gR	Ελληνικά::Επίπεδο Β1::Υπηρεσίες / Услуги, государственные службы	греческая почта	τα ελληνικά ταχυδρομεία, τα ΕΛΤΑ
Q2b;t}HPv_	Ελληνικά::Επίπεδο Β1::Υπηρεσίες / Услуги, государственные службы	водоснабжение и канализация столицы	η εταιρεία ύδρευσης και αποχέτευσης πρωτεύουσας, η ΕΥΔΑΠ
H;P>fjMkqE	Ελληνικά::Επίπεδο Β1::Υπηρεσίες / Услуги, государственные службы	греческая телекоммуникационная компания	ο οργανισμός τηλεπικοινωνίας Ελλάδος, ΟΤΕ
ogAMAW=&%0	Ελληνικά::Επίπεδο Β1::Υπηρεσίες / Услуги, государственные службы	железнодорожная компания Греции	ο οργανισμός σιδηροδρόμων Ελλάδας, ΟΣΕ
t(=HK53bnu	Ελληνικά::Επίπεδο Β1::Υπηρεσίες / Услуги, государственные службы	организация городского транспорта Афин	ο οργανισμός αστικών συγκοινωνιών Αθήνας, ΟΑΣΑ
KPlsNEL|1E	Ελληνικά::Επίπεδο Β1::Υπηρεσίες / Услуги, государственные службы	госслужащий	ο δημόσιος υπάλληλος
,R:@9d^r/	Ελληνικά::Επίπεδο Β1::Υπηρεσίες / Услуги, государственные службы	государственный служащий	ο κρατικός υπάλληλος
q`rVtm(f~m	Ελληνικά::Επίπεδο Β1::Υπηρεσίες / Услуги, государственные службы	директор / директриса	ο διευθυντής / η διευθύντρια
At]yNNlZc.	Ελληνικά::Επίπεδο Β1::Υπηρεσίες / Услуги, государственные службы	заместитель директора	ο υποδιευθυντής / η υποδιευθύντρια
J{2K|;:&kn	Ελληνικά::Επίπεδο Β1::Υπηρεσίες / Услуги, государственные службы	начальник отдела	ο προϊστάμενος / η προϊσταμένη τμήματος
kkBiiUK?VV	Ελληνικά::Επίπεδο Β1::Υπηρεσίες / Услуги, государственные службы	служащий / сотрудник	ο υπάλληλος
vahkXBg`Y*	Ελληνικά::Επίπεδο Β1::Υπηρεσίες / Услуги, государственные службы	индивидуальный налоговый номер	ο αριθμός φορολογικού μητρώου, ΑΦΜ
q4C15yHPR=	Ελληνικά::Επίπεδο Β1::Υπηρεσίες / Услуги, государственные службы	плачу налоги	πληρώνω φόρους
H}rrbF2%nW	Ελληνικά::Επίπεδο Β1::Υπηρεσίες / Услуги, государственные службы	налоговая декларация	η φορολογική δήλωση
kiQB}uI)Wo	Ελληνικά::Επίπεδο Β1::Υπηρεσίες / Услуги, государственные службы	оплачиваю дорожный налог	πληρώνω τέλη κυκλοφορίας αυτοκινήτου
CgvFv;xWy8	Ελληνικά::Επίπεδο Β1::Υπηρεσίες / Услуги, государственные службы	пенсия	η σύνταξη
mCfKuJ{4H<	Ελληνικά::Επίπεδο Β1::Υπηρεσίες / Услуги, государственные службы	медицинские обследования	οι ιατρικές εξετάσεις
Ok{YhFk:xf	Ελληνικά::Επίπεδο Β1::Υπηρεσίες / Услуги, государственные службы	подтверждение диплома	η αναγνώριση πτυχίου
Nmn>aL-oB+	Ελληνικά::Επίπεδο Β1::Η τράπεζα / Банк	ответственный сотрудник	ο αρμόδιος υπάλληλος
"AI<OS#m_~b"	Ελληνικά::Επίπεδο Β1::Η τράπεζα / Банк	персональный пин-код	ο μυστικός προσωπικός αριθμός
n|`(:c&;Im	Ελληνικά::Επίπεδο Β1::Η τράπεζα / Банк	блокирую карту	μπλοκάρω την κάρτα
Q8>=1aO(HR	Ελληνικά::Επίπεδο Β1::Η τράπεζα / Банк	осторожный / внимательный	προσεκτικός
O<.$x54Mi<	Ελληνικά::Επίπεδο Β1::Η τράπεζα / Банк	следую инструкциям	ακολουθώ τις οδηγίες
iK:D.f&q~R	Ελληνικά::Επίπεδο Β1::Η τράπεζα / Банк	потеря	η απώλεια
"c#QPxPB7N*"	Ελληνικά::Επίπεδο Β1::Η τράπεζα / Банк	кража	η κλοπή
"UU#xJ5h|n"	Ελληνικά::Επίπεδο Β1::Η τράπεζα / Банк	исправление	η διόρθωση
"c^jQY[7TN#"	Ελληνικά::Επίπεδο Β1::Η τράπεζα / Банк	вклад / депозит, пополнение	η κατάθεση
F}V_oc+m._	Ελληνικά::Επίπεδο Β1::Η τράπεζα / Банк	снятие (денег)	η ανάληψη
vL=;u}q4+U	Ελληνικά::Επίπεδο Β1::Η τράπεζα / Банк	остаток (на счёте)	το υπόλοιπο
N4jxyA3/bB	Ελληνικά::Επίπεδο Β1::Η τράπεζα / Банк	движение по счёту	η κίνηση λογαριασμού
E-hQw5X(il	Ελληνικά::Επίπεδο Β1::Η τράπεζα / Банк	активация карты	η ενεργοποίηση κάρτας
qg8j&35=n&	Ελληνικά::Επίπεδο Β1::Η τράπεζα / Банк	платежи	οι πληρωμές
"m&#)PyB5}H"	Ελληνικά::Επίπεδο Β1::Η τράπεζα / Банк	денежные переводы	οι μεταφορές ποσών / τα εμβάσματα
G9.&r$N&u6	Ελληνικά::Επίπεδο Β1::Η τράπεζα / Банк	нажимаю	πατάω, πάτησα, θα πατήσω
lfb,&Cp1Zp	Ελληνικά::Επίπεδο Β1::Μέσα μαζικής ενημέρωσης / Средства массовой информации	сижу в интернете, брожу по интернету	σερφάρω στο ίντερνετ
rP,ebkkF86	Ελληνικά::Επίπεδο Β1::Μέσα μαζικής ενημέρωσης / Средства массовой информации	журналист	ο δημοσιογράφος
pq5c~Om&%2	Ελληνικά::Επίπεδο Β1::Μέσα μαζικής ενημέρωσης / Средства массовой информации	ведущий / ведущая	ο παρουσιαστής / η παρουσιάστρια
Q~-xIT8zwL	Ελληνικά::Επίπεδο Β1::Μέσα μαζικής ενημέρωσης / Средства массовой информации	репортёр	ο ρεπόρτερ
E!&~X@YoxF	Ελληνικά::Επίπεδο Β1::Μέσα μαζικής ενημέρωσης / Средства массовой информации	оператор	ο καμεραμάν
tx(x7srIRv	Ελληνικά::Επίπεδο Β1::Μέσα μαζικής ενημέρωσης / Средства массовой информации	аудитория (телевизионная / радиослушатели / читатели)	το κοινό (τηλεοπτικό / ραδιοφωνικό / αναγνωστικό)
v^^nm2Olaj	Ελληνικά::Επίπεδο Β1::Μέσα μαζικής ενημέρωσης / Средства массовой информации	телезритель / телезрительница	ο τηλεθεατής / η τηλεθεάτρια
NbuU!qSi:J	Ελληνικά::Επίπεδο Β1::Μέσα μαζικής ενημέρωσης / Средства массовой информации	слушатель / слушательница	ο ακροατής / η ακροάτρια
Nl~WDi8yEP	Ελληνικά::Επίπεδο Β1::Μέσα μαζικής ενημέρωσης / Средства массовой информации	читатель / читательница	ο αναγνώστης / η αναγνώστρια
fukw+}]LM|	Ελληνικά::Επίπεδο Β1::Μέσα μαζικής ενημέρωσης / Средства массовой информации	новости / выпуск новостей	οι ειδήσεις / το δελτίο ειδήσεων
Osmcr[Rs`n	Ελληνικά::Επίπεδο Β1::Μέσα μαζικής ενημέρωσης / Средства массовой информации	информационная передача	η ενημερωτική εκπομπή
h{TZO~h~oA	Ελληνικά::Επίπεδο Β1::Μέσα μαζικής ενημέρωσης / Средства массовой информации	телевизионная игра	το τηλεπαιχνίδι
y^/wI[ltOq	Ελληνικά::Επίπεδο Β1::Μέσα μαζικής ενημέρωσης / Средства массовой информации	мультфильмы	τα κινούμενα σχέδια
e!@fTuODPF	Ελληνικά::Επίπεδο Β1::Μέσα μαζικής ενημέρωσης / Средства массовой информации	фильм	η ταινία / το φιλμ
n$hN|Tw2Ap	Ελληνικά::Επίπεδο Β1::Μέσα μαζικής ενημέρωσης / Средства массовой информации	документальный фильм	το ντοκιμαντέρ
J[K&xe02ky	Ελληνικά::Επίπεδο Β1::Μέσα μαζικής ενημέρωσης / Средства массовой информации	телесериал	η τηλεοπτική σειρά / το σίριαλ
Me-Jatm0Gb	Ελληνικά::Επίπεδο Β1::Μέσα μαζικής ενημέρωσης / Средства массовой информации	обсуждение	η συζήτηση
L$Q=-!qhTg	Ελληνικά::Επίπεδο Β1::Μέσα μαζικής ενημέρωσης / Средства массовой информации	интервью	η συνέντευξη
v{Ck,@C<0k	Ελληνικά::Επίπεδο Β1::Μέσα μαζικής ενημέρωσης / Средства массовой информации	спортивная передача	η αθλητική εκπομπή
wbFF=t-[oV	Ελληνικά::Επίπεδο Β1::Μέσα μαζικής ενημέρωσης / Средства массовой информации	реалити-шоу	το ριάλιτι σόου
"C-ewe#*d1c"	Ελληνικά::Επίπεδο Β1::Μέσα μαζικής ενημέρωσης / Средства массовой информации	кулинарная передача	η εκπομπή μαγειρικής
f?lGP$d&XC	Ελληνικά::Επίπεδο Β1::Μέσα μαζικής ενημέρωσης / Средства массовой информации	музыкальная / художественная передача	η εκπομπή μουσικής / τέχνης
j?A{IgKp>S	Ελληνικά::Επίπεδο Β1::Μέσα μαζικής ενημέρωσης / Средства массовой информации	реклама	οι διαφημίσεις
p^h9}I;yF:	Ελληνικά::Επίπεδο Β1::Είδη ταινιών / Жанры фильмов	греческий / зарубежный (фильм)	η ελληνική / η ξένη (ταινία)
ho/fdae)gd	Ελληνικά::Επίπεδο Β1::Είδη ταινιών / Жанры фильмов	детектив	η αστυνομική (ταινία)
plACY3Upz<	Ελληνικά::Επίπεδο Β1::Είδη ταινιών / Жанры фильмов	драма	η δραματική (ταινία)
hl`Y+$g_iw	Ελληνικά::Επίπεδο Β1::Είδη ταινιών / Жанры фильмов	исторический	η ιστορική (ταινία)
G*F-8vIlJL	Ελληνικά::Επίπεδο Β1::Είδη ταινιών / Жанры фильмов	социальный	η κοινωνική (ταινία)
ho@hd61VA?	Ελληνικά::Επίπεδο Β1::Είδη ταινιών / Жанры фильмов	военный	η πολεμική (ταινία)
"j+m#EWDWJQ"	Ελληνικά::Επίπεδο Β1::Είδη ταινιών / Жанры фильмов	триллер / фильм ужасов	το θρίλερ / η ταινία τρόμου
x~UaJfUK:*	Ελληνικά::Επίπεδο Β1::Είδη ταινιών / Жанры фильмов	комедия	η κωμωδία
"f~#=?z:Oy:"	Ελληνικά::Επίπεδο Β1::Είδη ταινιών / Жанры фильмов	мюзикл	το μιούζικαλ
Nb:?|%ebch	Ελληνικά::Επίπεδο Β1::Είδη ταινιών / Жанры фильмов	приключенческий фильм	η περιπέτεια
"e-l#kai[Rb"	Ελληνικά::Επίπεδο Β1::Είδη ταινιών / Жанры фильмов	научная фантастика	η ταινία επιστημονικής φαντασίας
z`PGD3ABx>	Ελληνικά::Επίπεδο Β1::Το ελληνικό εκπαιδευτικό σύστημα / Греческая система образования	ясли	ο παιδικός σταθμός
C@DfSs/OCL	Ελληνικά::Επίπεδο Β1::Το ελληνικό εκπαιδευτικό σύστημα / Греческая система образования	детский сад	το νηπιαγωγείο
LAMQ!$)!9>	Ελληνικά::Επίπεδο Β1::Το ελληνικό εκπαιδευτικό σύστημα / Греческая система образования	начальная школа	το δημοτικό
CW?}ee?%X8	Ελληνικά::Επίπεδο Β1::Το ελληνικό εκπαιδευτικό σύστημα / Греческая система образования	гимназия (средняя школа)	το γυμνάσιο
ig~2NJPF)s	Ελληνικά::Επίπεδο Β1::Το ελληνικό εκπαιδευτικό σύστημα / Греческая система образования	лицей (старшая школа)	το λύκειο
p5!TnY6%ss	Ελληνικά::Επίπεδο Β1::Το ελληνικό εκπαιδευτικό σύστημα / Греческая система образования	профессиональный лицей	το επαγγελματικό λύκειο
zP~Xvlck:s	Ελληνικά::Επίπεδο Β1::Το ελληνικό εκπαιδευτικό σύστημα / Греческая система образования	профессиональная школа	η επαγγελματική σχολή
vd[u9beuk6	Ελληνικά::Επίπεδο Β1::Το ελληνικό εκπαιδευτικό σύστημα / Греческая система образования	университет	το πανεπιστήμιο
"md#*SSr{i1"	Ελληνικά::Επίπεδο Β1::Το ελληνικό εκπαιδευτικό σύστημα / Греческая система образования	технологический институт	το τεχνολογικό εκπαιδευτικό ίδρυμα
Q~{hdv];u[	Ελληνικά::Επίπεδο Β1::Το ελληνικό εκπαιδευτικό σύστημα / Греческая система образования	институт профессионального обучения	το ινστιτούτο επαγγελματικής κατάρτισης
t:!1OfiYuT	Ελληνικά::Επίπεδο Β1::Το ελληνικό εκπαιδευτικό σύστημα / Греческая система образования	магистратура	οι μεταπτυχιακές σπουδές
"g46@3p%#6K"	Ελληνικά::Επίπεδο Β1::Το ελληνικό εκπαιδευτικό σύστημα / Греческая система образования	школьное насилие (физическое / вербальное / психологическое / социальное / кибербуллинг)	η σχολική βία (σωματική / λεκτική / ψυχολογική / κοινωνική / ηλεκτρονική)
wc%v{b13J,	Ελληνικά::Επίπεδο Β1::Το ελληνικό εκπαιδευτικό σύστημα / Греческая система образования	конфликты	οι συγκρούσεις
_jY&Ge+d3	Ελληνικά::Επίπεδο Β1::Το ελληνικό εκπαιδευτικό σύστημα / Греческая система образования	человеческие отношения	οι ανθρώπινες σχέσεις
mS/!>d4IPI	Ελληνικά::Επίπεδο Β1::Το ελληνικό εκπαιδευτικό σύστημα / Греческая система образования	конкуренция	ο ανταγωνισμός
h>[|ZPe>,4	Ελληνικά::Επίπεδο Β1::Το ελληνικό εκπαιδευτικό σύστημα / Греческая система образования	уважение	ο σεβασμός
Mla2rJEr7]	Ελληνικά::Επίπεδο Β1::Το ελληνικό εκπαιδευτικό σύστημα / Греческая система образования	успех	η επιτυχία
tQj|<^A3Fe	Ελληνικά::Επίπεδο Β1::Το ελληνικό εκπαιδευτικό σύστημα / Греческая система образования	неудача	η αποτυχία
H&ef=NT^!6	Ελληνικά::Επίπεδο Β1::Το ελληνικό εκπαιδευτικό σύστημα / Греческая система образования	экзамен	η εξέταση
ihufKm~ezJ	Ελληνικά::Επίπεδο Β1::Το ελληνικό εκπαιδευτικό σύστημα / Греческая система образования	кандидат / абитуриент	ο υποψήφιος / η υποψήφια
IBNr&+uhIH	Ελληνικά::Επίπεδο Β1::Το ελληνικό εκπαιδευτικό σύστημα / Греческая система образования	оценка	ο βαθμός
tUTWK>cXwu	Ελληνικά::Επίπεδο Β1::Το ελληνικό εκπαιδευτικό σύστημα / Греческая система образования	работа	η εργασία
kXs%|<a1L{	Ελληνικά::Επίπεδο Β1::Το ελληνικό εκπαιδευτικό σύστημα / Греческая система образования	профессиональная ориентация	ο επαγγελματικός προσανατολισμός
uX:!l!@`9-	Ελληνικά::Επίπεδο Β1::Το ελληνικό εκπαιδευτικό σύστημα / Греческая система образования	изучаю, учусь	μελετάω, μελέτησα, θα μελετήσω
LsZ6<)`qgr	Ελληνικά::Επίπεδο Β1::Επάγγελμα / Профессия	условия труда	οι συνθήκες εργασίας
-SxE*R-@W	Ελληνικά::Επίπεδο Β1::Επάγγελμα / Профессия	компенсация	η αποζημίωση
du=MD_QWP~	Ελληνικά::Επίπεδο Β1::Επάγγελμα / Профессия	жалоба, официальное заявление	η καταγγελία
l!^nPAuG?c	Ελληνικά::Επίπεδο Β1::Επάγγελμα / Профессия	трудовая инспекция	η επιθεώρηση εργασίας
uG6hw&e(F?	Ελληνικά::Επίπεδο Β1::Επάγγελμα / Профессия	квалификации / навыки	τα προσόντα
n&7q^-VB7m	Ελληνικά::Επίπεδο Β1::Επάγγελμα / Профессия	рабочая среда	το εργασιακό περιβάλλον
P03TcA=B`$	Ελληνικά::Επίπεδο Β1::Επάγγελμα / Профессия	перспективы роста	οι προοπτικές εξέλιξης
QF/OW>!E$	Ελληνικά::Επίπεδο Β1::Επάγγελμα / Профессия	доход / зарплата	οι αποδοχές
Ib7O&gtavx	Ελληνικά::Επίπεδο Β1::Επάγγελμα / Профессия	трудоустройство	η πρόσληψη
fY_<fDSe<$	Ελληνικά::Επίπεδο Β1::Επάγγελμα / Профессия	нанимаю / занимаю (работой)	απασχολώ, απασχόλησα, θα απασχολήσω
xhN0)NE6xF	Ελληνικά::Επίπεδο Β1::Επάγγελμα / Профессия	повышение (в т.ч. зарплаты)	η αύξηση
HHx,>=C-$f	Ελληνικά::Επίπεδο Β1::Επάγγελμα / Профессия	расходы	τα έξοδα
CB4rOdqWx0	Ελληνικά::Επίπεδο Β1::Επάγγελμα / Профессия	предприятие / бизнес	η επιχείρηση
I2!oK(mN%=	Ελληνικά::Επίπεδο Β1::Επάγγελμα / Профессия	подневная оплата	το μεροκάματο
E2X-NEo`zc	Ελληνικά::Επίπεδο Β1::Επάγγελμα / Профессия	начальник / начальница	ο προϊστάμενος / η προϊσταμένη
KVEI|^(`s+	Ελληνικά::Επίπεδο Β1::Επάγγελμα / Профессия	цветочник	ο ανθοπώλης
Ai}c?&L*bV	Ελληνικά::Επίπεδο Β1::Επάγγελμα / Профессия	капитан	ο καπετάνιος
hF?ymj5][X	Ελληνικά::Επίπεδο Β1::Επάγγελμα / Профессия	бортпроводник / стюардесса	ο αεροσυνοδός / η αεροσυνοδός
k[xyms$ZJV	Ελληνικά::Επίπεδο Β1::Επάγγελμα / Профессия	регулировщик / инспектор дорожного движения	ο τροχονόμος
sY[x>BGwPP	Ελληνικά::Επίπεδο Β1::Επάγγελμα / Профессия	фермер	ο αγρότης
vP{ywhQ%JE	Ελληνικά::Επίπεδο Β1::Επάγγελμα / Профессия	пилот	ο πιλότος
QAv?-y(IV7	Ελληνικά::Επίπεδο Β1::Επάγγελμα / Профессия	сантехник	ο υδραυλικός
kN9F!183Q=	Ελληνικά::Επίπεδο Β1::Επάγγελμα / Профессия	инженер-механик	ο μηχανολόγος
r@>5wQ(/Gu	Ελληνικά::Επίπεδο Β1::Επάγγελμα / Профессия	электрик	ο ηλεκτρολόγος
qy$U/97`E|	Ελληνικά::Επίπεδο Β1::Επάγγελμα / Профессия	садовник	ο κηπουρός
d1w.3%{?S*	Ελληνικά::Επίπεδο Β1::Επάγγελμα / Профессия	портной	ο ράφτης
"p*#KsG@0S4"	Ελληνικά::Επίπεδο Β1::Επάγγελμα / Профессия	судья	ο δικαστής
GUAx4$e{|&	Ελληνικά::Επίπεδο Β1::Επάγγελμα / Профессия	моряк	ο ναύτης
GR[XmS)Qt;	Ελληνικά::Επίπεδο Β1::Θέατρο, χόμπι / Театр, хобби	изобразительное искусство	τα εικαστικά
AdM_I;?tE0	Ελληνικά::Επίπεδο Β1::Θέατρο, χόμπι / Театр, хобби	выставка живописи / скульптуры / фотографии	η έκθεση ζωγραφικής / γλυπτικής / φωτογραφίας
"K(w##%/}(n"	Ελληνικά::Επίπεδο Β1::Θέατρο, χόμπι / Театр, хобби	труппа	ο θίασος
w5s3a$Nn=I	Ελληνικά::Επίπεδο Β1::Θέατρο, χόμπι / Театр, хобби	комедия	η κωμωδία
hQodj;A4Q`	Ελληνικά::Επίπεδο Β1::Θέατρο, χόμπι / Театр, хобби	сатирическое представление	η επιθεώρηση
l>`Nq7y;)	Ελληνικά::Επίπεδο Β1::Θέατρο, χόμπι / Театр, хобби	античная трагедия / античная драма	η αρχαία τραγωδία / το αρχαίο δράμα
EOeAcdi)TT	Ελληνικά::Επίπεδο Β1::Θέατρο, χόμπι / Театр, хобби	сцена	η σκηνή
A8hd4Vdw>$	Ελληνικά::Επίπεδο Β1::Θέατρο, χόμπι / Театр, хобби	партер	η πλατεία
Nnvfi_P}Pa	Ελληνικά::Επίπεδο Β1::Θέατρο, χόμπι / Театр, хобби	балкон (в театре)	ο εξώστης
jcNAoP4XCy	Ελληνικά::Επίπεδο Β1::Θέατρο, χόμπι / Театр, хобби	закулисье, закулисные интриги	το παρασκήνιο
"ex*LeLa3l#"	Ελληνικά::Επίπεδο Β1::Θέατρο, χόμπι / Театр, хобби	ставлю спектакль	ανεβάζω έργο
z:v74V48K}	Ελληνικά::Επίπεδο Β1::Θέατρο, χόμπι / Театр, хобби	режиссура	η σκηνοθεσία
L<!Bo!vOCh	Ελληνικά::Επίπεδο Β1::Θέατρο, χόμπι / Театр, хобби	режиссёр	ο σκηνοθέτης
C4XdI=B9&d	Ελληνικά::Επίπεδο Β1::Θέατρο, χόμπι / Театр, хобби	литературные книги	τα λογοτεχνικά βιβλία
MQQ0*pUm<@	Ελληνικά::Επίπεδο Β1::Θέατρο, χόμπι / Театр, хобби	вышивка	το κέντημα
Q`z6V]9[D$	Ελληνικά::Επίπεδο Β1::Θέατρο, χόμπι / Театр, хобби	шитьё	το ράψιμο
PUv@npQ,&R	Ελληνικά::Επίπεδο Β1::Θέατρο, χόμπι / Театр, хобби	изготавливаю украшения	κάνω κοσμήματα
b7y1X-+.Hp	Ελληνικά::Επίπεδο Β1::Θέατρο, χόμπι / Театр, хобби	лёгкая атлетика	ο στίβος
BH:K/VpnQM	Ελληνικά::Επίπεδο Β1::Θέατρο, χόμπι / Театр, хобби	собираю марки / монеты	μαζεύω γραμματόσημα / νομίσματα
"ib@wF{l#/5"	Ελληνικά::Επίπεδο Β1::Θέατρο, χόμπι / Театр, хобби	деятельность	η δραστηριότητα
f4R$It;R(O	Ελληνικά::Επίπεδο Β1::Θέατρο, χόμπι / Театр, хобби	награждение	η βράβευση
"w,{0-_*(p#"	Ελληνικά::Επίπεδο Β1::Θέατρο, χόμπι / Театр, хобби	немое кино	ο βωβός κινηματογράφος
oRRkiK;hV~	Ελληνικά::Επίπεδο Β1::Θέατρο, χόμπι / Театр, хобби	номинация / кандидатура	η υποψηφιότητα
hguUP@E4/h	Ελληνικά::Επίπεδο Β1::Θέατρο, χόμπι / Театр, хобби	сочиняю (музыку)	συνθέτω, συνέθεσα, θα συνθέσω
x%;B:SO)Qw	Ελληνικά::Επίπεδο Β1::Θέατρο, χόμπι / Театр, хобби	режиссирую	σκηνοθετώ, σκηνοθέτησα, θα σκηνοθετήσω
"dIzrq{#Y2G"	Ελληνικά::Επίπεδο Β1::Θέατρο, χόμπι / Театр, хобби	ставлю хореографию	χορογραφώ, χορογράφησα, θα χορογραφήσω
"dqfWi#;&Bp"	Ελληνικά::Επίπεδο Β1::Θέατρο, χόμπι / Театр, хобби	главный герой / актёр	ο πρωταγωνιστής
i>sQ7;?Fq?	Ελληνικά::Επίπεδο Β1::Θέατρο, χόμπι / Театр, хобби	импровизация	ο αυτοσχεδιασμός
H5:UO9R]C)	Ελληνικά::Επίπεδο Β1::Θέατρο, χόμπι / Театр, хобби	создаю	δημιουργώ, δημιούργησα, θα δημιουργήσω
i9),iK[Ixy	Ελληνικά::Επίπεδο Β1::Θέατρο, χόμπι / Театр, хобби	прогулка на лодке	η βαρκάδα
lDo04MV%`y	Ελληνικά::Επίπεδο Β1::Θέατρο, χόμπι / Театр, хобби	верховая езда	η ιππασία
KMl$2beYsA	Ελληνικά::Επίπεδο Β1::Θέατρο, χόμπι / Театр, хобби	местоположение	η τοποθεσία
k4D>)50hJQ	Ελληνικά::Επίπεδο Β1::Οικογένεια / Семья	тёща / тесть (или свекровь / свёкор)	η πεθερά / ο πεθερός
x(`Q&,YAoU	Ελληνικά::Επίπεδο Β1::Οικογένεια / Семья	бывший / бывшая	ο πρώην / η πρώην
D0f_o+b^^W	Ελληνικά::Επίπεδο Β1::Οικογένεια / Семья	сводный брат / сводная сестра	ο ετεροθαλής αδελφός / η ετεροθαλής αδελφή
D<+>o$(@,d	Ελληνικά::Επίπεδο Β1::Οικογένεια / Семья	развод	το διαζύγιο
PxR_lOZ13;	Ελληνικά::Επίπεδο Β1::Οικογένεια / Семья	единственный ребёнок в семье	το μοναχοπαίδι
o5(=^dnFzu	Ελληνικά::Επίπεδο Β1::Ταξίδια / Путешествия	организую	οργανώνω, οργάνωσα, θα οργανώσω
jc8aYAbjr<	Ελληνικά::Επίπεδο Β1::Ταξίδια / Путешествия	информирую	ενημερώνω, ενημέρωσα, θα ενημερώσω
huN;zT7NCz	Ελληνικά::Επίπεδο Β1::Ταξίδια / Путешествия	отменяю	ακυρώνω, ακύρωσα, θα ακυρώσω
KKzemOl/oh	Ελληνικά::Επίπεδο Β1::Ταξίδια / Путешествия	возмещаю убытки	αποζημιώνω, αποζημίωσα, θα αποζημιώσω
AJP7gu`2Qq	Ελληνικά::Επίπεδο Β1::Ταξίδια / Путешествия	взлёт	η απογείωση
es}9*-:4c|	Ελληνικά::Επίπεδο Β1::Ταξίδια / Путешествия	посадка	η προσγείωση
m4@zD*B&N@	Ελληνικά::Επίπεδο Β1::Το σώμα, αρρώστιες / Тело, болезни	большой палец	ο αντίχειρας
CdSEF>;DBS	Ελληνικά::Επίπεδο Β1::Το σώμα, αρρώστιες / Тело, болезни	лодыжка	ο αστράγαλος
Emk19u>}BI	Ελληνικά::Επίπεδο Β1::Το σώμα, αρρώστιες / Тело, болезни	пупок	ο αφαλός
"K#qvFFeypD"	Ελληνικά::Επίπεδο Β1::Το σώμα, αρρώστιες / Тело, болезни	мозг	ο εγκέφαλος
Q>U+ZK9s3Q	Ελληνικά::Επίπεδο Β1::Το σώμα, αρρώστιες / Тело, болезни	запястье	ο καρπός
v}Nc}b+{ds	Ελληνικά::Επίπεδο Β1::Το σώμα, αρρώστιες / Тело, болезни	мышцы	οι μύες
"Q/]L/#hDFu"	Ελληνικά::Επίπεδο Β1::Το σώμα, αρρώστιες / Тело, болезни	нервы	τα νεύρα
Oq7?VYn`m)	Ελληνικά::Επίπεδο Β1::Το σώμα, αρρώστιες / Тело, болезни	кости	τα οστά (τα κόκαλα)
oWuVOEu7hY	Ελληνικά::Επίπεδο Β1::Το σώμα, αρρώστιες / Тело, болезни	ладонь	η παλάμη
GwMcq9R+f7	Ελληνικά::Επίπεδο Β1::Το σώμα, αρρώστιες / Тело, болезни	лёгкие	οι πνεύμονες
I@XrJsp[X!	Ελληνικά::Επίπεδο Β1::Το σώμα, αρρώστιες / Тело, болезни	желудок	το στομάχι
g?p]g+7?BP	Ελληνικά::Επίπεδο Β1::Το σώμα, αρρώστιες / Тело, болезни	грудь, грудная клетка	το στήθος
s>za-=m]zr	Ελληνικά::Επίπεδο Β1::Το σώμα, αρρώστιες / Тело, болезни	перелом	το σπάσιμο
rx>Z!FN.Ry	Ελληνικά::Επίπεδο Β1::Το σώμα, αρρώστιες / Тело, болезни	головокружение	η ζαλάδα
c)DmFwyTC/	Ελληνικά::Επίπεδο Β1::Το σώμα, αρρώστιες / Тело, болезни	отравление	η δηλητηρίαση
K]L&L~6tNi	Ελληνικά::Επίπεδο Β1::Το σώμα, αρρώστιες / Тело, болезни	выздоровление	η ανάρρωση
L9?%RH&j%D	Ελληνικά::Επίπεδο Β1::Το σώμα, αρρώστιες / Тело, болезни	аллергия	η αλλεργία
gyW4LUokB~	Ελληνικά::Επίπεδο Β1::Το σώμα, αρρώστιες / Тело, болезни	стресс / тревога	το άγχος
DLM[.%`|tE	Ελληνικά::Επίπεδο Β1::Η συζήτηση, εκφράσεις / Беседа, фразы	μου ακούγεται καλό	звучит хорошо
mJ:+O44?qR	Ελληνικά::Επίπεδο Β1::Η συζήτηση, εκφράσεις / Беседа, фразы	Έχεις πάει πότε σε αυτό το εμπορικό κέντρο;	Ходила уже в этот торговый центр?
rw5SX6h(ni	Ελληνικά::Επίπεδο Β1::Η συζήτηση, εκφράσεις / Беседа, фразы	κάποτε είχαμε πάει 	когда-то давным давно ездили
fg./tj2e7j	Ελληνικά::Επίπεδο Β1::Η συζήτηση, εκφράσεις / Беседа, фразы	συνεννοηθήκαμε πολύ καλά 	хорошо поладили друг с другом
J;USmulkcA	Ελληνικά::Επίπεδο Β1::Η συζήτηση, εκφράσεις / Беседа, фразы	Ο'τι πληρώνεις, παίρνεις 	Что посеешь, то и пожнёшь 
v3;u$gCCjB	Ελληνικά::Επίπεδο Β1::Η συζήτηση, εκφράσεις / Беседа, фразы	Πόσα χρήματα σας οφείλω;	Сколько я вам должен?
jaCQFc)Jv$	Ελληνικά::Επίπεδο Β1::Η συζήτηση, εκφράσεις / Беседа, фразы	Δεν πληρώνω μια περιουσία 	Не хочу всё потратить (устойчивое выражение)
bJcE:8$oHU	Ελληνικά::Επίπεδο Β1::Η συζήτηση, εκφράσεις / Беседа, фразы	Είσαι βδέλλα	Ты как пиявка
E7js8+P;MV	Ελληνικά::Επίπεδο Β1::Η συζήτηση, εκφράσεις / Беседа, фразы	Κάνε υπομονή	Потерпи
NBfbAr*DwU	Ελληνικά::Επίπεδο Β1::Η συζήτηση, εκφράσεις / Беседа, фразы	Ησυχία, τάξη και ασφάλεια 	Всё устаканилось (букв. тишина, порядок, безопасность)
